㔂	lân	
㘛		khâm
㤉	gê	
㧌	mau	
㧎	khê	
㧒	hiat	
㧣	tu	
㧻	tok	
㨂	tàng	
㨑	tsang	
㨨	liû	
㨪		hainnh
㨻	tsānn	
㴘	bāu	
㴙	tsha̍p	
㷮	tsau	
㽎	sìm	
㾀	khiap	
䀐	siam	
䆀	bái	
䈄	ham	
䖙	the	thenn
䖳	thē	
䘥	kah	
䘼	ńg	uínn
䠡	tshê	
䢢	tshiāng	
䫌	phué	phé, phuí
䲅	kui	
一	tsi̍t, it, --tsi̍t	
丁	ting	
七	tshit, tshi	
丈	tiūnn, tiōng, tn̄g	tiōnn
三	sann, sam, sàm, san	
上	siōng, tsiūnn, tshiūnn, siāng, sióng, --siōng	tshiōnn, tshiū, tsiōnn
下	ē, hā, e, hē	enn, ēnn
不	put, puh	
丑	thiú	thiúnn
且	tshiánn	tshé
丕		phi
世	sè, sì	sí
丘	khu, khiu	
丙	piánn, píng	
丞		sîng
丟	tiu	
並	phīng, pīng	
个	ê	
中	tiong, tiòng, tìng	ting, tong
串	tshuàn, tshǹg	
丸	uân	
丹	tan	
主	tsú	tsí
丼	tôm	
乃		nái
久	kú, kiú	
么	io	
之	tsi	
乍	tsànn	
乎	honnh, --honnh	
乏	ha̍t, hua̍t	
乒		phīn
乓		piàng, phōng
乖	kuai	
乘	sīng, sîng	
乙	it	
乜	mí	
九	káu, kiú	
乞	khit	
也	iā	ā
乩	ki	
乳	lú, jú	lí, jí, jínn, gí
乾	kuann, kan, khiân, ta	
亂	luān, lān	
了	liáu, --liáu	
予	hōo, hō	hōng
事	sū, tāi	
二	jī, lī, --lī, --jī	gī
云	ûn	
互	hōo	
五	gōo, ngóo	
井	tsénn, tsínn, tsíng	
亞	a	
亡	bông	
亢		khòng
交	kau, ka, kiau, kāu	
亥	hāi	
亦	i̍k	
亨	hing	
享	hiáng, hióng	
京	kiann, king	
亭	tîng	
亮	liāng, liōng	
人	lâng, jîn, lîn, --lâng	n̂g, gîn
仁	jîn, lîn	lin, gîn
仃		ting
仄	tseh	tsik
仆	phak	
仇	siû, kiû	
今	kin, tann, kim	
介	kài	
仔	á, --á, ah, tsú	
仕	sū	
他	thann, ta	tha
仗	tiōng	tiāng
付	hù	
仙	sian, sián	tshian, tshan
仝	kāng, kâng	
仟	tshian	
代	tāi, tài, tē, tè	
令	līng, lîng	
以	í	
仰	gióng, ióng	
仲	tiōng	
仵	ngóo	
件	kiānn	
任	jīm, līm, jîm, lîm	
份	hūn	hun
仿	hóng	
企	khì	
伊	i, --i	ī
伍	ngóo	
伏	ho̍k	
伐	hua̍h, hua̍t	huā
休	hiu	
伙	hué, hé	
伨	thīn	
伯	peh, pit, phik, pik	
估	kóo	
伴	phuānn, phuān	
伶	líng	lîng
伸	tshun, sin	tshng
伻	phenn	
似	sāi, sū	
佃	tiān	
但	nā, tān	niā
佇	tī	tū
佈	pòo	
位	uī	
低	kē	te
住	tsū	
佐	tsò	
佑	iū	
佔	tsiàm	
何	hô, uâ	
佗	tó, toh, tá	tah, tio̍h
佘	siâ	
余	î, û	
佛	hu̍t, pu̍t	
作	tsok, tsoh	
佟	tông	
你	lí, --lí	lú
佩	puē, phuè	
佬	láu, ló	
佮	kah, kap	
佯	tènn, tìnn	
佳	ka, kha	kai
併	pìng	
使	sái, sú, sài, sù	saih, siah
來	lâi, --lâi, lai	
例	lē	
侍	sāi, sū	sī
侏		tsu
侖		lûn
侗	tòng	
供	king, kiong, kìng	
依	i	
侮	bú	
侯	hôo, hâu, kâu	
侵	tshim	
侷	kio̍k	
侹	thiānn	
便	piān, pân	
係	hē	
促	tshik, tshiok	
俄	ngôo, gô	
俊	tsùn	
俍	lāng	
俏	tshio, tshiàu	
俐	lī	
俗	sio̍k, sio̍h	siok
俘	hu	
俚	lí	
保	pó	
俞	lû, jû, jî	
俠	kiap	
信	sìn	
修	siu	
俯	hú	
俱	khū	
俳	pai, pâi	
俸	hōng	
俺	án	
倆	lióng	
倉	tshng, tshong	
個	kò	kô, kóo, kâinn
倌	kuann	
倍	puē	pē
倏	suā	
倒	tò, tó, tho̍h, --tó	táu
倖	hīng, sīng	
候	hāu	hiō
倚	uá, í	
借	tsioh, tsià	
倡	tshiòng, tshiong	
倦	kuān	
倩	tshiànn	
倪	gê	
倫	lûn	
倭	e	
倯	sông	
值	ta̍t, ti̍t	
偃	ián	
假	ké, ká, kà, kè	
偈		khì
偉	uí	
偌	guā, juā	luā
偏	phian, phinn	
偓		òo
偕	kai	
做	tsò, tsuè	
停	thîng	
偝	āinn, iāng	āng
健	kiān, kiānn	
側	tshik	
偵	tsing	
偶	ngóo	
偷	thau	
偽	guī	
傀	ka, khuí	
傅	hū, pòo	
傍	pn̄g, pōng	
傑	kia̍t	
傘	suànn, sàn	
備	pī	
催	tshui	
傱	tsông	
傲	ngōo	
傳	thuân, thn̂g, tuān	tuân, thuînn, tn̂g
債	tsè	
傷	siunn, siong	sionn
傾	khing	
僆	nuā	luā
像	tshiūnn, siōng	tshiōnn
僑	kiâu	
僕	po̍k	
僚	liâu	
僥	hiau	
僧	tsing, sing	
僫	oh	
僭	tsiàm	tshiàm
僮		tông
僱		kòo
僵	khiong	
價	kè, kà	
僻	phiah	
儀	gî	
億	ik	
儉	khiām	
儑	gām	
儒	lû, jû	
儘	tsīn, tsín	
償	siông, sióng	
儡	lé	
優	iu	
儱	láng	
儲	tû	
儳	sâm	sām
儷		lē
儸		lô
儼	giám	
允	ín, ún	
元	guân	
兄	hiann, hing	
充	tshiong	
兆	tiāu	
兇	hiong	
先	sing, sian, sin	
光	kong, kng	kuinn
克	khik	
兌	tuī, tuē	tuê
免	bián	
兒	jî, lî	
兔	thòo	
兜	tau	
入	ji̍p, li̍p	
內	lāi, luē	
全	tsuân, tsn̂g	tsuînn
兩	nn̄g, lióng, niú	nióo
八	peh, pat, pueh, pa	
公	kong, kang, káng, king	
六	la̍k, lio̍k	
共	kā, kāng, kiōng	
兵	ping	
其	kî	
具	kū, khū	
典	tián	
兼	kiam	
冇	phànn	
冊	tsheh	tshik
再	tsài	
冒	mōo	
冗	liōng, līng	
冠	kuan	kuàn
冤	uan	
冥	bîng	
冬	tang, tong	
冰	ping	pin
冶	iá	
冷	líng	
准	tsún	
凊	tshìn, tshìng	tshì
凋	tiau	
凌	lîng	
凍	tàng, tòng	
凜		lím
凝	gîng	
凡	huân, huān	hān
凰	hông	
凱	khái, ke	
凶	hiong	hing
凸		tu̍t
凹	nah, neh, āu, lap	
出	tshut, --tshut, tsut	
函	hâm	
刀	to	
刁	tiau, thiau	
刃		jīm
分	hun, pun, hūn	
切	tshiat, tshè	khi̍t
刊	khan	
刎		bún
刐	táinn	tán
刑	hîng	
划	kò	
列	lia̍t	
刜	phut	
初	tshoo, tshe, tshue	
刣	thâi	
判	phuànn	
別	pa̍t, pia̍t	
利	lī, lāi	
刪	san	
刮	khe, kueh, kuat, kuih	
到	kàu, tàu, tò	
制	tsè	
刷	suat	
券	kuàn, kǹg	
刺	tshiah, tshì	
刻	khik	
剁	tok	
剃	thì	thè
則	tsik	
剉	tshò	
削	siah, siat	
剋	khik	
剌	lua̍h	la̍t
前	tsîng, tsiân, tsûn	tsū, tsâinn, tsân
剔	thak, thik	
剖	phóo	
剛	kong	
剝	pak, pok	
剩	siōng, sīng, sīn	
剪	tsián	
副	hù	
割	kuah, kat	
創	tshòng, tshong	
剷	thuánn	
剺	le̍h, lì	
剾	khau	
剿	tsâu	
劃	ue̍h, ui̍h, i̍k, uē	
劇	kio̍k, ki̍k	
劈	phik	
劉	lâu	
劌	kuì	
劍	kiàm	
劑	tse, tsè	
力	li̍k, la̍t, lí	
功	kong, kang	
加	ke, ka	
劣	lua̍t	
助	tsōo	
努	lóo	
劫	kiap	
勁	kīng, kìng, ngē	
勃	pu̍t	
勇	ióng	
勉	bián	
勍	khiang	
勒	lik, li̍k	
動	tōng, tāng	thām
勘	kham, khàm	
務	bū	
勝	sìng, sing	
勞	lô, lóo, lō	lôo
募	bōo	
勢	sè, sì	
勤	khîn, khûn	
勥	khiàng	
勳	hun	
勵	lē	
勸	khǹg, khuàn	khuìnn
勺		sia̍h
勻	ûn	iân
勼	kiu	
勾	kau	
勿	bu̍t	
包	pau, pâu	
匆	tshong	
匏	pû	
化	huà, hua	
北	pak, pok	
匙	sî	
匠	tshiūnn	tshiōnn
匡	khong	
匪	huí	
匯	huē	huê
匹	phit	
匼	khap	
匾	pián	
匿	li̍k	
區	khu, oo, tshī	
十	tsa̍p, si̍p	
千	tshian, tshing	
升	sing, tsin	
午	ngóo, gōo	
半	puànn, puàn	piàn
卌	siap	
卑	pi	
卒	tsut	
卓	toh, tok, tá	
協	hia̍p, ha̍h	
南	lâm	
博	phok	
卜	pok, poh	
占	tsiàm, tsiam	
卡	khah, kha̍h	khá
卦	kuà	
卯	mauh, báu	
印	ìn	
危	guî, uî	huî, luî
即	tsik	
卵	nn̄g, luán	nuī
卷	kńg, kuàn, kǹg	kuínn
卸	sià	
卹		sut
卻	khiok	
卿	khing	
厄	eh	
厘	lî	
厚	kāu, hōo	hiō
厝	tshù, liâu	
原	guân, uân	
厭	ià, iàn	
厲	lī, lē	
去	khì, --khì, khi	khù
參	tsham, sim, som	sam, song
又	iū	
叉	tshe	
及	ki̍p	
友	iú	
反	huán, píng	páinn, puínn, pán
叔	tsik, siok	
取	tshú	
受	siū, siūnn	
叛	puān	
叡	luē, juē	
叢	tsâng, tsông	
口	kháu, káu, khió	
古	kóo	
句	kù	
另	līng	
叨	lo	tho, lu
叩	khàu, khiò	
只	tsí	
叫	kiò	
召	tiàu	
叭	pah	
叮	tìng, ting	
可	khó, khuá, khóo, khoo	khónn
台	tâi	
叱		tshit, tshi̍h
史	sú, sái	
右	iū	
司	si, sai, su	
各	kok, koh	
合	ha̍p, ha̍h, kap, kah	
吉	kiat, jì	
吊	tiàu	
吋	tshùn	
同	tông, tâng	
名	miâ, bîng	
后	hiō, āu, hōo	
吏	lī	
吐	thóo, thòo	
向	hiòng, ǹg, hiànn, hiàng, ànn	
吒		tshia
君	kun	
吝	līn	
吞	thun	
吟	gîm	
吠	puī, huī	
否	hónn, phí	hóo
吧	pa	
吩	huan, hun	
吪		o, ô
含	kâm, hâm, kânn	
吭	khōng, khngh	
吮	tshńg	tsuīnn, tsn̄g
吱	ki	
吳	ngôo, gôo	
吵	tshá, tsháu	
吶	nā	
吸	khip	khi̍p, hiap
吹	tshue, tshe, tshui	
吻	bún	
吼	háu	ha̍unnh
吾	ngôo	
呂	lū, lī	
呃	eh	è
呆	tai	
呈	thîng	tîng
告	kò	
呔	thài	thah
呢	ne, nî, --neh, --nih, ní, ni	neh, nih
呧	ti	
周	tsiu	
呱	kuā	kua̍k, kua̍t, kop
呲	tshū	
味	bī	
呴	ku	
呵	o	ha
呸	phuì	
呺		hau
呻	tshan, sin	
呼	hoo, khoo, honn	
命	miā, bīng	
呾	tànn	
呿	khuh	
咁		kām
咂	tsa̍p	
咇	phi̍h	
和	hô, huê, hām, hō, hê	hâm
咍	hai	
咎	kiū	
咐	hù	
咑		tā, tah
咒	tsiù	
咕		kū, koo, kú
咖	ka	
咧	teh, leh, --leh	tih, lih, lê
咩	meh	
咪	bî	mi, bi, mî, bi̋
咫	tsí	
咬	kā, ngáu	
咯	ko̍k, kha̍k, lo̍k	kok
咱	lán	tsa
咳	ka, kha	
咸		hâm
咻	hiu	
咽	ian	
咾	ló	
哀	ai	
品	phín	
哆	to	
哈	ha, hah, há	hā, ha̍h
哉	tsài, tsai	
哎	ai, aih, --aih	
哖	nî	
員	uân, înn, guân	
哥	ko, koh, --ko, --koh	
哦		ōnn, ónn
哨	siàu, sàu	
哩	li, lí, mai, --lih	lih
哪	ná	nà, lô
哭	khàu	
哮		hàu
哱		phū
哲	tiat	thiat
哹	pu	
哺	pōo	ko, koo
哼	hainn, hngh, --hngh	hmh
哽	kénn, kínn	kê
唅	hannh, --hannh	
唆	sō, so	
唇	tûn, sûn	
唉	haih	
唌	siânn	
唏	hì	
唐	tn̂g, tông	
唔	onn	
唚	tsim	
唧		tsik
唬	hóo	
唭	kì, ki	
售	siū	
唯	bî, uî	bī
唱	tshiùnn, tshiàng, tshiòng	tshiònn
唷	ioh, --ioh	
唸	liām	
唾	thò	
唿	hut	
啄	tok	teh
商	siong, înn	
啉	lim	
啊	ah, --ah	a
問	mn̄g, būn	muī
啖	tām, tam	
啞	é, á	énn
啟	khé	
啡	pi	
啤		pî
啥	siánn	sánn, siannh, sannh
啦	--lah	lah
啼	thî	thê
啾	tshiùnn	
喀	khe̍nnh, khennh	
喁		gū
喂	uê, --ueh, --eh, ueh, eh	
喃	nauh	
善	siān	
喆		tsiat
喇	lá	
喈	kainn	
喉	âu	
喊	hiàm, hán	
喋	thi̍h	sah
喌	tsiuh, tsû	tsű, tsu
喎		ua
喑	ìnn	
喓	iaunn	
喔	ooh, oh, --ooh	op
喘	tshuán	
喙	tshuì	
喚	huàn	
喜	hí	
喝	huah, hat	há
喢	sannh	
喧	suan	
喨	liang	
喪	song, sòng, sng	
喬	kiâu	
單	tuann, tan	
喲	iō	
喳	tshā	
喵		miau, niau, ngiau
喻	jū, lū	
嗄	sà	sah
嗆		tshiong
嗇	sik, siah	
嗑		khap
嗔		tsin
嗕		ngauh, nauh
嗙	pòng, phngh	
嗚	oo, onn	
嗝	keh	
嗣	sū, sû	
嗤	tshi, tshi̍h	
嗦	so	
嗨		ha̍ih, hái
嗲	teh, te	
嗷		ô, oh, uh, âu
嗹	liân, lian	
嗺	sui	
嗽	sàu	
嗾	tsa̍k	
嘆	thàn	
嘈	tsha̍uh, tsō	
嘉	ka, kā	
嘎		khia̍k
嘐	hau	
嘓	go̍k, ko̍k, kho̍k, kok	khok
嘔	áu, óo	
嘖	tsheh, --tsheh	
嘗	siông	
嘛	mā, mà, --mah	mah
嘟	tū	
嘩	huā	hua
嘮	lo	
嘯	siàu	
嘰		ki
嘵		hiau
嘹	liâu	
嘻	hi	
嘿	heh, --heh	hēnn, hennh, hiàu, hènn
噁	ònn	
噍	ta	
噎	uh	ap
噓	si	su̍t, sū, su
噗	pho̍k, phok, pok	
噢		a̍uh, auh
噤	khiūnn	khiōnn, kìm
器	khì	hì
噪	tshò	soh, sò
噬		sē
噭	kiàu	
噯	ài, aih	
噴	phùn	
噶	kat	
噷	hm̍h	
噸	tòng, tùn	
噹	tang	
噼		piah
嚀	lîng	
嚆		ô
嚇	hiannh, heh, hánn, hik	hennh, hē
嚎		hô
嚓	tshia̍k	
嚙	gè	
嚨	nâ, lông	liông
嚮	hiòng	
嚴	giâm	
嚵	tshànn	
嚶	inn	ìnn
嚷	jiáng, lióng	jióng, gióng, giáng
嚾	uang	
囂	hiau	hia
囉	lo, lô, lō, --looh	looh, loh, ooh
囊	lông, long	lôm
囑	tsiok	
囚	siû	siûnn
四	sì, sù	
囝	kiánn	kánn
回	huê, hê	
囟	sìn	
因	in	
囡	gín	
囤	tún	
囥	khǹg	
囫	hut	
囮	buê	
困	khùn	
囷	khûn	
固	kòo	
圃		phóo
圇	lûn, lun, n̂g, nn̂g	nuî
圈	khian, khuan, khuân	
國	kok	
圍	uî, û	iû
園	hn̂g, uân, huînn	
圓	înn, uân	
圖	tôo	
團	thuân	
圜	huân	
土	thóo, thôo	
在	tsāi	
圭	kui	
地	tē, tuē, tè, tī	lī
圳	tsùn	
圾	sap	
址	tsí	
坂		pán
均	kin, kun	
坉	thūn	
坊	hong, hng	
坌	hun	
坎	khám	gám, kham
坐	tsē, tshē, tsō	
坑	khenn, khinn, khing, khe	
坡	pho	
坤	khun	
坦	thán, thánn	
坩	khann	
坪	pênn, pînn, phiânn, phîng, pîng	phînn, phênn
坯	phue, phe	
坱	ing	
坵	khu, khiu	
坷	khia̍t	
垂	suî, suê, sê	
垃	lah, lâ	lap
型	hîng	
垢	káu	
垣	uân	
垺	pû	phû
埃	ia, ai	
埆	kak	kat
埋	tâi, bâi	
城	siânn, sîng	
埒	lua̍h	
埔	poo	
埕	tiânn	
域	hi̍k, i̍k	
埠	poo, pōo	
埤	pi	
執	tsip	
培	puê, puē	
基	ki, ke	
埽	sò	
堀	khut	
堂	tn̂g, tông	
堅	kian	
堆	tui	
堊		ok
堡	pó	
堤	thê	
堪	kham	
堯	giâu	
報	pò	
場	tiûnn, tshiâng, á	tiônn
堵	tóo	
塊	tè	khuài
塌	thap, lap	la̍p
塑	sok	
塔	thah	tshah
塗	thôo, tôo	thô
塘	tn̂g, tông	
塚	thióng	
塞	sat, sài	
填	thiām	
塭	ùn	
塵	tîn	
塹	tsām, tshàm	
塾	sio̍k	
境	kíng	
墈		khàm
墊	tiām	
墓	bōng, bōo	bāng
墘	kînn	
墜	tuī	
增	tsing	
墟	hi	
墨	ba̍k, bi̍k	
墩	tun	
墮	tuī	
墳	phûn, hûn	
墼	kat	kak
墾	khún	
壁	piah, pik	phik
壅	ìng	
壇	tuânn, tân	
壓	ap, ah	
壕	hô	
壘	luí	
壙	khòng	
壚		lôo
壞	huāi	hāi
壟	lóng, lâng, lang	lióng
壢	li̍k	
壤		jióng
壩	pà, pè	
士	sū	
壬	jîm, lîm	līm, jīm
壯	tsòng	
壹		it
壺	ôo, hôo	
壽	siū	
夏	hā, hē	
夕	sia̍h, si̍k	
外	guā, guē	
多	to, kak	
夜	iā	
夠	kàu	
夢	bāng, bōng	
夥	hué, hé	
大	tuā, tāi, ta, thái, tá	
天	thinn, thian	
太	thài, thā, tāi, thāi	
夫	hu	
夭	iáu	
央	iang, ng, iong	ing
夯	giâ	kiâ, gia̍h
失	sit	
夷	î	
夸		khua
夾	ngeh	ngueh, gue̍h, gueh
奅	phānn	
奇	kî, khia	kha, khiann
奈	nāi, ta	
奉	hōng	
奏	tsàu	
契	khè, khuè	
奒	hai	
奔	phun	pun
奕	ī	
套	thò	
奚	hê	
奠	tiān	
奢	tshia	
奧	ò	
奪	tua̍t	
奮	hùn, pùn	
女	lú, lí	
奴	lôo	
奶	ling, ni, nai, ne	lin, nái
奸	kan	
好	hó, hònn	
如	jû, lû	jî, lî
妃	hui	
妄	bōng	
妍	gián	giân
妒	tòo	
妓	ki	
妖	iau	
妗	kīm	
妙	miāu	biāu
妝	tsng, tsong	
妣	pí	
妥	thò	
妨	hông	
妮	nî	
妯		ti̍k
妲	thán	
妹	muē, bē	muāi, māi
妻	tshe	tshie
妾	tshiap	
姆	ḿ	
姊	tsí, tsé	tsié
始	sí, sú	
姐	tsiá	tsê, tsiáu
姑	koo	
姒	sāi	
姓	sènn, sìng, sìnn	
委	uí	
姚	iâu, iô	
姜	kiunn, khiong, kiong, khiunn	khionn
姦	kàn, kan	
姨	î	înn
姪	ti̍t, tsit	
姬	ki	
姻	in	im
姼	tshit	
姿	tsu	
威	ui	
娃	ua	
娉	phing	
娌		lí
娑		so
娗	thānn	
娘	niû, niâ, liông	niôo, niô
娛	ngôo, gôo, gû	
娜	ná	
娟	kuan	
娥	ngôo	
娩	bián	
娵		tsoo
娶	tshuā	
娼	tshang, tshiong	
婁	lôo	
婆	pô	
婉	uán	
婊	piáu	
婚	hun	
婢	pī	
婦	hū, pū	
婷	tîng	
婸	giang	
婿	sài, sè	
媌	bâ	
媒	muê, hm̂, muî	muâi, hûn
媚	bī	
媠	suí	
媧	o	
媳	sik	
媽	má, mah, ma	
嫁	kè, kà	
嫂	só	
嫌	hiâm	
嫖	phiâu	
嫡	tik	
嫣	ian	
嫦	siông	
嫩		lūn
嬈	hiâu	
嬉	hi	
嬌	kiau	
嬭	lé	
嬰	enn, inn, ing, ìnn	ne, ni, mi
嬸	tsím, sím	
孀	song	
子	tsí, tsú, jí, lí, á	
孔	khóng, kháng	
孕	īn	
字	jī, lī	gī, jū
存	tsûn, tshûn	tshūn
孜	tsu	
孝	hàu, hà	
孟	bīng	
季	kuì	
孤	koo	
孩	hâi	
孫	sun, sng	
孵	pū, hu	
學	ha̍k, o̍h	
孽	gia̍t	
宅	the̍h, thi̍k	
宇	ú	
守	siú, tsiú	tsiúnn
安	an, uann, án	
宋	sòng, sàng	siòng
完	uân	
宏	hông	
宕	thōng	tōng
宗	tsong	
官	kuann, kuan	
宙	tiū	
定	tiānn, tīng	
宛	uán	
宜	gî	
客	kheh, khik	
宣	suan	
室	sik	tsit
宥	iū	
宦	huān	
宮	kiong, king, má	
宰	tsáinn	tsái
害	hāi	
宴	iàn	
宵	siau	
家	ke, ka, kā	kai
容	iông	
宿	siok, siù, sok	
寂	tsi̍k, siok	
寄	kià, kì	kiànn, kia̍h, khia̍h, khiā, kiat
寅	în	
密	ba̍t, bi̍t	
寇	khòo	
富	hù, pù, hô	
寐	bī	
寒	kuânn, hân, gân	
寓	gū, ú	ù
寞	bo̍k	
察	tshat	
寡	kuá	kuánn
寢	tshím, khím	
寥	liâu	
實	si̍t, tsa̍t	
寧	lîng	
寨	tsē	
審	sím	
寫	siá	
寬	khuann, khuan	
寮	liâu	
寵	thíng, thióng	
寶	pó	
寸	tshùn	
寺	sī	
封	hong, pang	
射	siā	
將	tsiong, tsiòng, tsiàng	
專	tsuan	
尉	ut	uì
尊	tsun	
尋	siâm, sîm	
對	tuì, uì	
導	tō	
小	sió, siáu	sia̋u
少	siàu, tsió, siáu	
尖	tsiam	
尚	siūnn, sióng, siōng	siōnn
尤	iû	
尪	ang	
就	tō, tsiū	tiō, tio̍h, to̍h, tsū
尹	ún	
尺	tshioh, tshe, tshik	
尻	kha	ka
尼	nî, lî	luî
尾	bué, bé	
尿	jiō, liō	giō
局	kio̍k	
屁	phuì	
屄	bai	
居	ki, ku	
屆	kài	
屈	khut	
屋	ok	
屍	si	
屎	sái, sú	
屏	pîn, pîng, hè	
屐	kia̍h	kiā, khia̍h
屑	sut, sap	
展	tián, thián	
屘	ban	
屜	thuah	
屠	tôo	
屢	lí	
層	tsân, tsàn	
履	lí	
屧	siap	
屬	sio̍k, tsiok	
屯	tūn, tùn, tun	
山	suann, san, sán	
岐		kî
岑		gîm
岡	kong, kng, kóng	
岩	giâm, gâm	
岫	siū	
岳	ga̍k	
岸	huānn, gān	
峇	bā, bâ	
峨	ngôo	
峰	hong	
島	tó, tóo	
峻	tsùn	
峽	kiap	
崁	khàm	
崇	tsông	
崎	kiā	kî
崔	tshui	
崖	gâi	
崗	kong, kang	
崙	lūn, lun, lún	lûn
崧		siông
崩	pang, ping	
嵌	khàm	
嵐	lâm	
嵙	kho, khoo	
嵯	tshu	
嶄	tsám	
嶠	kiau	
嶢		giâu
嶺	niá, líng	
嶼	sū	sī
嶽	ga̍k	
巒	luân, bân	
巔		tian
巖	giâm	
川	tshng, tshuan	tshuinn
州	tsiu	
巡	sûn	
巢	tsâu	
工	kang, khang, kong	
左	tsó	
巧	khiáu, khá, kháu	
巨	kū, kī	
巫	bû	
差	tsha, tshe, tshai, tsua̍h	
己	kī, kí	tī
已	í	
巳	tsī, sū	
巴	pa	
巷	hāng	
巽		sùn
巾	kin, kun	
市	tshī	
布	pòo	phòo
帆	phâng, huân	
希	hi	
帕	phè	phà
帖	thiap	
帙	tia̍t	
帚	tshiú	tsiú, siú
帛	pe̍h, pi̍k	pē
帝	tè	
帥	suè, suì	
師	su, sai	si
席	si̍k	
帳	tiùnn, tiòng	tiònn
帶	tuà, tài	
帷	uî	
常	siông, tshiâng	
帽	bō	
幅	pak, hok	
幌	hàinn	hiù
幔	mua	
幕	bōo	
幡	huan	
幢	tông	
幣	pè	
幫	pang, png	phóng
干	kan	
平	pîng, pênn, pînn, piânn, tsām	phîng
年	nî, liân, --nî	
幸	hīng	
幹	kàn	
幻	huàn	
幼	iù	
幽	iu	
幾	kuí, kí	
庄	tsng	
庇	pì	pí
床	tshn̂g, sn̂g, tshông	
序	sī, sū	
底	té, tué, tī	tí
店	tiàm	
庚	kenn, king, kinn	
府	hú	
度	tōo, to̍k	
座	tsō	
庫	khòo	
庭	tîng, tiânn	
庵	am	
康	khong, khng	
庸	iông	
庾	lú, jú	
廁	tshè	
廂	siunn	siong
廈		hā
廉	liâm	
廊	lông	
廍	phōo	
廕	ìm	
廖	liāu	
廚	tôo, tû	tô
廟	biō	
廠	tshiúnn	tshiónn
廢	huì	huè
廣	kóng, kńg	
廨		kài
廬	lôo	
廳	thiann, thing	
延	iân, tshiân	
廷	tîng	
建	kiàn	
廿	jia̍p, lia̍p	
弄	lāng, lōng, lòng	
弊	pè, piah	
式	sik, sit	
弓	king, kiong	kin
弔	tiàu	
引	ín	
弘	hông	
弟	tī, tē	
弦	hiân	
弧	hôo	
弩		lóo
弱	jio̍k, lio̍k	
張	tiunn, tng, tiong	tionn
強	kiông, kiōng, kióng	
弼		pi̍t
彈	tuânn, tuānn, thân, tān, tân	
彌	mí, bî, mî, nî	ní
彎	uan	
彗	huī	
彙	luī	
形	hîng	
彤		tông
彥	giān, gān	
彧		hiok
彩	tshái	
彪	piu	
彬	pin	
彭	phînn, phênn, phîng	
彰	tsiong, tsiang	
影	iánn, íng	
彷	hóng	
役	i̍k, ia̍h	
彼	hit, he, pí	
彿	hut	
往	óng, íng	
征	tsing	
待	thāi, tāi	
徊		huê
律	lu̍t	
後	āu, hāu, hiō, hōo	
徐	tshî	
徑	kìng	
徒	tôo	
得	tit, tik, --tit	eh, tsit, lit, te
徘	pâi	
徙	suá	
徛	khiā	
從	tsiông, tsîng, tshiong	
御	gū	
復	ho̍k	
循	sūn, sûn	
微	bî, bui, bi	
徵	ting, tin	
德	tik	
徹	thiat	
徼	khiò	
心	sim	sin
必	pit	
忌	khī, kī	kì
忍	jím, lún, lím	
忖	tshún	
志	tsì	
忘	bōng	bông
忙	bâng, bông	
忝	thiám	
忠	tiong	
忤	ngóo	
快	khuài, khuìnn	khuànn
念	liām	
忽	hut	
忿	hún	
怎	tsuánn	nuá, ná, tsáinn
怏	ǹg	
怐	khòo	
怒	nōo	
怕	phà	phànn
怖	pòo	
怙	kōo	
思	su, sù, si	
怠		tāi
怡	î	
急	kip	
怦	phēnn	phīnn, phānn
性	sìng, sènn, sìnn	siàng
怨	uàn	
怪	kuài, kuè	
怫	phut	
怯	khiap	
恁	lín	
恂	sún	sńg
恃		sī
恆	hîng	
恍	huánn, hóng	
恐	khióng	
恕	sù	
恢	khue, hue	
恣		sù
恥	thí	
恨	hūn, hīn	
恩	un, in	
恬	tiām	
恭	kiong	
息	sit, sik	
悄		tshiáu
悅	ia̍t, ua̍t	
悉	sik	
悔	hué, huí	
悖	puē	
悟	ngōo	gōo
悠	iu	
患	huān	
悲	pi	
悴	tsuī	
悶	būn	
悼	tō	
悽	tshi	tshinn
悾	khong	
情	tsîng, tsiânn	
惑	hi̍k	
惘	bóng	
惜	sioh, sik	
惝	tshíng	
惟	î, uî	
惠	huī	
惡	ok, ònn	
惰	tuānn, tō	
惱	ló, lóo, náu	nóo
想	siūnn, sióng	siōnn
惶	hiânn	hông
惹	jiá, liá	
惻	tshik	
愁	tshiû	
愈	jú, lú	
愉	lû, jû	
愍	bián	
意	ì	
愕	go̍k	
愖	sīm	
愚	gû	
愛	ài	
感	kám	
愣	gāng	
愧	khuì	
愿		guān
慄	la̍k, lik	
慈	tsû	
態	thài, thāi	
慌	hong	
慍	ùn	
慎	sīn	
慒	tso	
慕	bōo	
慘	tshám	
慟		tōng
慢	bān	
慣	kuàn	
慧	huē, huī	
慨	khài	
慮	lī, lū	
慰	uì	
慳	kian	
慶	khìng	
慷	khóng	
慼	tsheh, tshueh, tshik	tshuè
慾	io̍k	
憂	iu	
憎		tsing
憐	liân, lîn	
憑	pîn, pîng	
憔	tsiâu	
憚	tān	
憢	giâu	
憤	hùn	
憫	bín	
憲	hiàn	
憶	ik	
憾	hām	
懂	táng, tóng	
懇	khún	
應	ìng, ìn, ing	iòng, iong, hun
懊	àu	
懍	lún	nńg, líng
懦	nōo	
懲	tîng	
懵	bòng, bóng	
懶	lán, nuā	
懷	huâi	kuî
懸	kuân, hiân	kuâinn
懺	tshàm	
懼	kū	
懿	ì	
戀	luân, luān	
戇	gōng	
戈	ko, gòo	
戊	bōo	
戌	sut	
成	sîng, tsiânn, tshiânn, siânn	
我	guá, ngóo	
戒	kài	
或	hi̍k	
戚	tshik	
戛	khiat	
戟	kik	
戥	tíng	tín
截	tsia̍t	tsue̍h
戮	lak, lio̍k	
戰	tsiàn	
戲	hì	hí
戳	thok	
戴	tì, tè, tài	
戶	hōo	
戽	hòo	
戾	lē	
房	pâng, pông	
所	sóo	
扁	pínn, pún, pián, pín	pán, phián
扇	sìnn, siàn	
扈	hōo	
手	tshiú, siú	teh
才	tsiah, tsâi, tshâi	
扎	tsah	
扑	phok	
扒	pê, pe	
打	tánn, tá	tiám
托	thok, thuh	
扛	kng, kong	
扞	huānn	
扣	khàu, khau	
扦	tshuann	
扭	liú, ngiú, niú, láu	náu, gió
扮	pān	
扯	tshé	
扱	khi̍p	
扲	gīm	gîm
扳	pian, pán	penn, pan
扴	ke̍h	
扶	hû, phôo	
扷	ió	
批	phue, phe, phi	
扼	i̍k	
找	tsāu	
承	sîng, sîn	
技	ki	
抄	tshau	
抉	kuat	
把	pá, pé, pà	
抌	tìm	
抐	lā	lâ
抑	ia̍h, iah, ah	a̍h
抓	jiàu, liàu	niàu, giàu, ngiàu
抔	put	
投	tâu	
抗	khòng	
折	tsiat, tsi̍h, tsik	
抨	phiann	piann
披	phi	
抰		ng, uinn
抱	phō, pō, phāu	
抵	tí, té	
抹	buah	
押	ah, ap	
抽	thiu	liu, thio
抾	khioh	
抿	bín	bián
拂	hut	
拄	tú, tuh	
拆	thiah	liah
拇	bú, bó	
拈	liam, ne, ni	
拉	lá, la, lâ	ba
拊	hú	
拋	pha, phau	phann
拌	puānn	
拍	phah, phik	
拎	lîng	
拐	kuái, kuāinn	kuáinn, kuāi, kuainnh, kuaih
拑	khînn	
拒	kū, kī	
拓	thok	
拔	pue̍h, pua̍t, pua̍h	pui̍h, pua̍nnh, puē
拖	thua	
拗	áu	áunn
拘	khu	
拙	tsuat	
拚	piànn	
招	tsio, tsiau	
拜	pài	
括	kuat, kuah	
拭	tshit	
拯	tsín	
拱	kióng	
拳	kûn, kuân	
拶		suán
拷		khó
拹	hia̍p	
拼	phing	
拾	si̍p	
拿	ná	
持	tshî, tî	
挂	kuì	
挃	ti̍h	ti̍nnh
指	tsí, tsíng, tsáinn, kí	tsńg, tsuínn, tsái, tsín, tsán
挈	khe̍h	
按	án, àn	
挌	keh	
挐	jû, lû	
挑	thio, thiau, thiáu	
挓	thà	
挔	hiannh	
挕	hìnn	
挖	óo, ué, uat	
挨	e, ue, ai	
挩	thuah	
挫	tshò	
振	tín, tsín	
挲	so	
挵	lòng	
挹	ip	
挺	thánn, thíng	
挼	juê, lê	jê
挽	bán	
挾	gia̍p, nge̍h	
捀	phâng	
捅	thóng	
捆	khún	
捉	tshiok	
捋	lua̍h, luah	luā, lua̍ih
捌	bat	pat
捎	sa	
捏	tēnn, lia̍p, liap, tīnn	
捐	kuan	
捒	sak	sat
捔	ka̍k	
捕	póo	
捗	pôo	pu, pô, pōo
捘	tsūn	
捙	tshia	
捥	ńg	uínn, áinn
捧	phóng	
捨	siá	
捲	kńg	kuínn
捶	tuî	
捷	tsia̍p, tsia̍t	
捻	liàm, liām	
捽	sut	tsu̍t, su̍t
捾	kuānn	
掀	hian	
掂	tìm	
掃	sàu, sò	
掇	tuah, tua̍h	
授	siū	
掉	tiāu	
掌	tsióng, tsiúnn, tsiáng	tsiónn
排	pâi	
掔	khian	
掖	iā	
掘	ku̍t	
掙	tsiānn	
掛	kuà, khuà	
掜	tau	
掠	lia̍h, lio̍k	
採	tshái	
探	thàm, thàn	
掣	tshuah, tshiat	
接	tsiap, tsih	
控	khòng, khàng	
推	thui, the, tshui	
掩	ng, am, iám, om	uinn
措	tshòo	
掮	khainn	kháinn
掰	pué	pé
揀	kíng, kán	káinn
揆		kuî, puî
揈	hong	
揉	jiû, liû	
揌	sai	
揍	bok	
描	biô, biâu	
提	the̍h, thê	thē, thue̍h, e̍h
插	tshah, tshap	
揙		pinn
揚	iông	
換	uānn	huān
揜	iap	
握	ak, ok, ap	at
揣	tshuē, tshē	
揤	tshi̍h	li̍h, tshī, ji̍h, jī
揫	tshiû	
揬	tu̍h	tuh, tū
揭	khiat, kiat	
揮	hui	
揲	tia̍p	
援	uān	
揹	phāinn	pē
揻	ui	
搉		khà
損	sńg, sún	suínn
搏	phok	
搐	tiuh	
搖	iô, iâu	ôo, oo
搙	jio̍k, lio̍k	
搜	tshiau, soo	
搝	khiú	giú
搟	hián	
搢	tsìnn	
搣	me, mi	
搤	iah	
搥		tuî
搦	la̍k	
搧	siàn, sàm	
搩	kiat	
搪	tn̄g	
搬	puann, puan	
搭	tah, tap, tā	
搵	ùn	
搶	tshiúnn, tshióng	tshiónn
摁	hmh	
摃	kòng	
摒	piànn	
摔	siak, siàng	
摖	tshè, tshuè	
摘	tiah, tik	
摠	tsáng	
摧	tshui	
摩	môo	
摯	tsì	
摳	kha̍unnh	
摵	tshi̍k	
摸	bong, moo, boo	
摹	bōo, bôo	
摺	tsih	tsí
摻	tsham, tshàm	
撆	pih	
撇	phiat	
撈	hôo	lāu
撋	nuá	
撏	jîm, lîm	
撐	the	thenn
撒	suah, sat	
撓	ngiáu	
撙	tsún	
撚	lián	
撞	tōng	
撟	kiāu	
撠	giah	kiah
撤	thiat	
撥	puah, puat	
撨	tshiâu, tshâu	
撩	liô, liâu	
撫	bú, hu, hú	
撬	kiāu	
播	pòo	pò
撮	tshok, tsuat	
撰	tsuān	
撲		phok
撼	hám	
擁	ióng	
擂	luî	
擅	siān	
擇	to̍h, ti̍k	
擉	tia̍k	thak, tiak, tak, ta̍k
擊	kik	
擋	tòng	
操	tshau, tsho, tshò	tshiau
擎	king, khîng	
擒	khîm	
擔	tann, tànn, tam	
擗	phia̍k	phiak, pia̍k, phiang
擘	peh	
據	kì, kù	
擛	ia̍t	
擠	tsik	
擢	tioh	
擤	tshìng	tshǹg, sǹg
擦	tshat	
擬	gí	
擲	tàn	
擴	khok	phok
擷		khiat
擸	bā	
擺	pái	páinn
擽	ngiau	iau
擾	jiáu, liáu	
攀	phan	
攄	lu	
攆		lián
攏	lóng, láng	
攑	gia̍h	kia̍h
攔	ânn, nuâ, lân	
攕	tshiám, tshiam	
攘		giāng, jiāng
攜	hê	
攝	liap	
攢	tshuân	
攤	thuann, than	
攪	kiáu	
攬	lám	
支	tsi, ki	
攲		khi
收	siu	
改	kái	
攻	kong	
放	pàng, hòng	
政	tsìng	
故	kòo	
敆	kap	
效	hāu	
敉		bí
敏	bín	
救	kiù	
敗	pāi	
敘	sū	
教	kàu, kà, kah	
敝	pè, pē	
敢	kám, kánn	kiám, kán, ká
散	sàn, suànn, suánn, sán	
敦	tun	
敧	khi	
敨	tháu	
敬	kìng	
敱	kháinn	
敲	khà, khau	
整	tsíng	
敵	ti̍k	
敷	hu	
數	siàu, sòo	
斂	liám	
斃	pē	
文	bûn	muî
斌	pin	
斐	huí, hui	
斑	pan	pian
斗	táu, tóo	
料	liāu	
斜	tshua̍h, tshiâ, siâ	
斟	tsim, thîn	
斡	uat	
斤	kin, kun	
斥	thik	
斧	póo, hú	pú
斬	tsánn, tsám	
斯	su, suh	
新	sin	
斷	tn̄g, tuān, tuàn	tuīnn
方	hong, hng, png	puinn
於	î	
施	si, sì	
旁	pông	
旅	lí, lú	
旋	suan, tsn̄g, suân	tsuīnn
族	tso̍k	
旗	kî	
既	kì	
日	ji̍t, li̍t, --li̍t, --ji̍t	gi̍t
旦	tuànn, tàn	
旨	tsí	
早	tsá, tsái	
旬	sûn	
旭	hiok	
旱	huānn, uānn, hān	
旺	ōng	
昂	gông	
昆	khun	
昇	sing	
昊	hō	
昌	tshiong	
明	bîng, bîn, mê, miâ	mî, muâ, mâ
昏	hng, hūn, hun	huinn
易	i̍k, ia̍h, ī	
昔	sik	
星	tshenn, tshinn, san, sing	
映	ìng, iòng	
春	tshun	tshing
昧	māi	
昨	tsa, tso̍h	tsa̍h, tsoo
昭	tsiau	
是	sī, si, --sī	tsī, sū
昱	io̍k	
晁	tiâu	
時	sî, --sî	
晃	huánn	hóng
晉	tsìn	
晏	uànn, àn	
晚	mńg, buán	
晝	tàu, tiù	
晟	tshiânn, sīng	
晡	poo	
晨	sîn	
晬	tsè	
普	phóo, puh	
景	kíng	
晴	tsîng, tsênn	
晶	tsinn, tsing	
智	tì	
晾	nê	nî
暇	hā	
暈	n̄g, ūn	hūn
暉	hui	
暑	sú	
暖	luán	
暗	àm	
暝	mê, mî	
暢	thiòng	
暨	kì	
暫	tsiām	
暮	bōo	
暱	li̍k, li̍t	
暴	pō, pok, po̍k	
暸		liâu
曆	li̍k, la̍h	lā
曉	hiáu	hiáng
曖	ài	
曜	iāu	
曝	pha̍k, pho̍k	
曠	khòng	
曰	ua̍t	
曲	khiau, khik, khiok	
更	kenn, king, kinn, kìng	
曷	a̍h	ia̍h
書	su, tsu	si
曹	tsô	
曼	bān	
曾	tsîng, tsan, tsing	
替	thè, thuè	
最	tsuè	
會	ē, huē, hē, kuè	uē
月	gue̍h, ge̍h, gua̍t, --ge̍h, --gue̍h	guē
有	ū, iú	
朋	pîng	
服	ho̍k	
朒	tsut	lut
朔	sok	
朕	tīm	
朗	lóng, láng	
望	bāng, bōng	
朝	tiâu, tiau	
期	kî, ki	
木	bo̍k, ba̍k	
未	buē, bī, bē	
末	bua̍h, bua̍t	buah, buā
本	pún, pńg	
札	tsat	
朱	tsu	
朴	phoh	
朽	hiú	
杆	kan, kuann, kuainn	
杉	sam	
李	lí	
杏	hīng	
材	tsâi	tshâi
村	tshun, tshuan	
杓	sia̍h	tshiā, siā
杖	thn̄g, tiōng	
杙	khi̍t	
杜	tōo	tuā
杞	kí	
束	sok	
杭	hâng	
杮	phuè	phè
杯	pue	
杰	kia̍t	
東	tang, tong	
杴		hiam
杵	thú	
杷	pê	
松	siông, tshîng, sóng	
板	pán, pang	
枇	pî	gî, khî, tî, pînn
枉	óng	
枋	pang	
析	sik	
枕	tsím	
林	nâ, lîm, ná	niá, nâi
果	kó, kué, ké	
枝	ki, tsi	
枯	koo	
枴	kuái, kuáinn	
枵	iau	
架	kè, khuè, kà, khè	
枷	kê, kha, ka	kuê, ké
枸	kóo	
柄	pènn, pìnn, pìng	
柏	pik, peh	
某	bóo	móo
柑	kam	
染	ní, jiám, liám	
柔	jiû, liû	
柙	kah	
柚	iū	
柝	kho̍k	
查	tsa, tshâ	ta
柩	kiū	
柫	put	kut
柬	kán	
柯	kua, kho	
柱	thiāu, tsū	
柳	liú	
柴	tshâ	tshâi, sâ
柵	sa, tshik	
柺		kuáinn, kuái
柿	khī	
栓	sng, tshng	
栗	li̍k, la̍t	
校	hāu, kàu	
株	tu, tsu	
栱	kông, kong, kóng	kióng
核	hi̍k, hu̍t, ha̍t	
根	kin, kun	
格	keh, kik, ga	
栽	tsai	
栿	pha̍k, ho̍k	
桀	kia̍t	
桂	kuì	
桃	thô, tô	
桅	uî	
框	khing, khong	
案	àn, uànn	
桌	toh	tooh
桐	tông, tâng	
桑	sng, song, sáng	
桔	kiat	kit
桮	pue, pe	puē
桱	kènn, kìnn	
桶	tháng	
桷	kak	
桸	hia	
桿	kuáinn	
梁	niû	niôo, liông
梅	muê, muî, m̂, buê	muâi
梓	tsú	
梔	ki	
梗	kíng, kénn	kuínn
梘	kíng	
條	tiâu, liâu	
梟	hiau	
梢	sau	
梧	ngôo, gôo	
梨	lâi, lê	
梭	so	
梯	thui, the	
械	hāi	kài, hâi
梳	se, sue	
梵	huān	
棄	khì	
棉	mî, biân	
棋	kî	
棍	kùn	
棑	pâi	
棒	pāng	
棕	tsang	
棗	tsó	
棚	pênn, pînn, pîng	
棟	tòng, tàng	
棠	tông	
棧	tsàn	tsiàn
森	sim	som
棰	tshê, tshuê	
棲	tshe	
棺	kuan, kuann	
椅	í	
植	si̍t, ti̍t	tsi̍t
椏	ue	uāinn
椒	tsio, tsiau	
椪	phòng	
椰	iâ	
椹		suî
楂		tsa
楊	iûnn, iông, tshiûnn	iônn, tshiû
楓	png, hong	
楔	seh	sueh
楗	kīng	kāinn, kān
楚	tshó, tshóo	
楝	līng, liān	
楞	gông	
楠	lâm	
楣	bâi	
楦	hùn	
楨		tsing
楬	at	
業	gia̍p	
極	ki̍k	
楷	khái	
楹	ênn, îng	înn
概	kài, khài	
榆	liû, jiû	
榔	lông, nn̂g	
榕	tshîng, iông	tsîng, siông
榛	tsin	
榜	pńg, póng	
榨	tsà	
榫	sún	
榮	îng	
榴	liû	
榻	thap, thah	
槃		phuân
槊		so̍k
構	kòo	
槌	thuî	
槍	tshiunn	tshionn
槐	huâi	
槓	kǹg, không	kòng
槔	oo	
槤	liân	
槳	tsiúnn	tsiónn
槺	khong	
槽	tsô	
樂	lo̍k, ga̍k, ngāu	
樊	hân, huân	
樑	niû, liông	niôo
樓	lâu	lôo
標	piau, pio, phiau	
樞	tshu	su
樟	tsiunn, tsiong	tsionn
樠	miâ	
模	bôo	
樣	iūnn, iōng	iōnn
樵	tsiâu	
樸	phoh, phok	
樹	tshiū, sū	
樺	huā, huâ	
樽		tsun
橂	tīng	tān, tāinn
橄	kan, kann, kám	
橋	kiô, kiâu	
橐	lok, lop, lak	
橙		tîng, tshiâng
橛	kue̍h	
機	ki, kui	ke
橫	huâinn, huînn, hîng	huênn
檀	tuânn, tân	
檔	tóng, tòng	
檜	kuè	
檠	kiânn	
檢	kiám	
檣		tshiông
檨	suāinn	
檫	tshat	
檬	bóng	
檯	tâi	
檳	pin	pun
檸	lê	
櫃	kuī	
櫓	lóo	
櫛		tsiat
櫞	înn	iân
櫥	tû	
櫳	lang, lông	
櫻	ing	
櫼	tsinn	
欄	nuâ, lân	
欉	tsâng	
權	khuân, kuân	
欖	ná, lám	
欠	khiàm	
次	tshù	
欣	him	
欱	hap	hop
欲	beh, bueh, io̍k	boh
欶	suh	
欸	eh, --eh	
欹	khia	
欺	khi	
欽	khim	
款	khuán, khuánn	
歁	khám	
歆	him	
歇	hioh	hennh, heh
歉	khiàm, khiam	khiám
歌	kua, ko	kuai
歎	thàn	
歐	au, io	
歕	pûn	
歡	huann, huan	
止	tsí	
正	tsiànn, tsìng, tsiann	
此	tshú	tsiùnn, tsú
步	pōo	
武	bú	
歧	kî	
歪	uai, uainn	
歲	huè, hè, suè	
歷	li̍k	
歸	kui	
歹	pháinn, phái, tái	
死	sí, --sí, sú	
殃	iong	
殉	sûn	
殊	sû	
殕	phú	
殖	si̍t, si̍k	
殗	giān	
殘	tsân, tshân, tsuânn	
殭	khiong	kiong
殮	liām	
殯	pin	
段	tuānn, tuān	
殷	ûn, in, un	
殺	sat	
殼	khak, khok	
殿	tiān	
毀	huí	
毅	gī, gē	
毋	m̄	
母	bú, bó, bió	bóo
每	muí	
毒	to̍k, thāu, ta̍k	
比	pí	phí
毛	mn̂g, môo, moo	bûn, mî, mng
毫	hô, hôo	
毬	kiû	khiû
毯	thán	
毽	kiàn	
毿	sàm	
氅	tsháng	
氈	tsinn	
氏	sī, --sī	
民	bîn	
氓		bîn
氛	hun	
氣	khì, khuì	
氧	ióng	
水	tsuí, suí	
永	íng	
汁	tsiap	tsap
求	kiû	
汐	si̍p, si̍k	
汗	kuānn, hān	
汙	u, ù	ú
汛		sìn
江	kang, káng	
池	tî	
污	u	
汨		bi̍k
汪	ong	na̍uh, ngáu, hóm, ha̍unnh
汫	tsiánn	
汰	thuā, thài	
汴	piān, pān	
決	kuat	
汽	khì	
沂		kîn
沃	ak	
沈	sím	
沉	tîm, tiâm	
沌	tūn	
沐	bak, bo̍k	
沒	bu̍t	
沓	ta̍uh, ta̍p	
沕	bi̍t	
沖	tshiâng, tshiong	
沙	sua, sa, se	sie
沛	phài	
沢	tshioh	
沫	phue̍h, phe̍h	
沬	bī	
河	hô	ôo
沸	huì	
油	iû	
治	tī	
沼	kū, tsau	tsiáu
沽		koo
沾	tsam	
沿	iân	
況	hóng	
泄	tshuā, siat	
泅	siû	
泉	tsuânn, tsuân	
泊	phik, po̍k	
泌	pì	
泏	tsuah, tsuat, tsuh	
泓	hông	
泔	ám	
法	huat	
泛	huàn, huān	hàm
泡	phàu, pho, pho̍k, phò	phau
波	pho	
泣	khip	
泥	nî	
注	tsù, tù	
泮		phuàn
泯		bín
泰	thài	
泱	iann, iong	
泳	íng	
泵	pōng	
洄	huê	
洋	iûnn, iông	iônn
洒	sè	
洗	sé, sué	
洘	khó	khóo, khò
洛	lo̍k, lok	
洞	tōng	
津	tin, tsin	
洩	sia̍p	siat
洪	âng, hông	
洲	tsiu	
活	ua̍h, hua̍t	ua̍t
派	phài	
流	lâu, liû	
浙	tsiat	
浞	tshio̍k	
浡	phu̍h, phū	
浣		uān
浦	phóo	phu, phú, phu̍h, phuh
浩	hō	
浪	lōng, lâng	
浮	phû, hû	
浯		ngôo
浴	i̍k, io̍k	
海	hái	
浸	tsìm	tsìng
涂	thôo, tôo	
涅		liap
消	siau	
涉	sia̍p	
涎	siân	
涓		kuan
涗	suè, sè	
涯	gâi	
液	sio̍h, i̍k	
涵	âm, hâm	
涸	khok	
涼	liâng, niû	lîng, liông
淇	kî	
淋	lâm, lîm	
淑	siok	
淒	tshe	
淘	tô	
淚	luī	
淝		huî
淡	tām, tānn	
淨	tsīng	
淪	lûn	
淫	îm	
淮	huâi	
深	tshim	
淵	ian	
混	hūn	
淹	im	
淺	tshián, khín	
添	thiam, thinn	
清	tshing, tshinn	tshuinn
減	kiám	
渝	lû, û, jû	
渠		kû
渡	tōo, tāu	
渣	tse	
渧	tè	
測	tshik	
渭		uī
港	káng	
渴	khuah, khat	
游	iû	
渺	biáu	
渾	hûn	
湄		bî
湖	ôo	hôo, ngôo
湘	siong	
湠	thuànn	
湢	pih	
湧	íng, ióng	
湮		ian
湯	thng, thong	
湳	làm	
溉	kài	
源	guân	
準	tsún	
溜	liu, liù	
溝	kau, koo	
溡	tshî	
溢	ik	
溪	khe, khue, khenn	
溫	un	
溯	sòo	
溶	iûnn, iông	iônn
溺	li̍k	
溼	sip	
滂	phōng	pōng
滄	tshong	
滅	bia̍t	
滇	tīnn, tian	
滋	tsu	
滑	ku̍t	
滒	kō	
滓	tái, lái, tsáinn	
滬	hōo	
滯	tù, tī	
滲	siàm	
滴	tih, tik	
滷	lóo	
滸	hóo	
滾	kún	
滿	muá, buán	
漁	hî, hû, gû	
漂	phiò, phiau, phiàu	pio
漆	tshat	
漉	lo̍k, lok	
漏	lāu, lōo	
演	ián	
漖	kà	
漚	àu, au, áu	
漠	bo̍k	bôo
漢	hàn, hān	
漩	suān	suan
漫	bān	
漱		suah
漲	tiùnn, tiòng	tiònn
漳	tsiang, tsiong	
漸	tsiām	
漾		iōng
漿	tsiunn, tsiong	tsionn
潑	phuah, phuat	
潔	kiat	
潘	phun, phuann, phuan	
潛	tsiâm	
潟		sik
潢	hông	
潤	jūn, lūn	
潦	ló	
潭	thâm	
潮	tiâu, tiau, tiô	
潰	khuì	huī, huì
潲	siâu	
潺	tshan	
澀	siap	
澄	tîng	
澈	thiat	
澍	tshū	
澎	phênn, phînn	
澗	kán	kàn
澡	tsó	
澤	ti̍k	
澩	ha̍unnh	
澳	ò, ù	
澹	tâm	
激	kik	ki̍k, khik
濁	lô, to̍k, ta̍k	
濃	lông, long	
濆	bùn	
濛		bông
濟	tsē, tsè, tsuē	
濤	tôo, tô	
濫	lām	
濱	pin	
濺	tsuānn	
濾	lī	
瀆		to̍k
瀉	sià	
瀑		po̍k, pho̍k
瀕		pîn
瀘	lū	
瀚	hān	
瀛		îng
瀟	siau	
瀧	liông	
瀨	luā	
瀳	tshînn	
瀾	nuā, lân, liân	
灇	tsâng	
灌	kuàn	
灑	sá	
灘	thuann, than	
灣	uân, uan	
火	hué, hé, hónn	
灰	hue	he
灶	tsàu, tsò	
灸	kù	
災	tsai, tse	
炊	tshue, tshe	
炎	iām	
炒	tshá	tsháu
炕	khòng	
炙	tsià	
炤	tshiō	
炫	hiān	
炭	thuànn	
炮	phàu	
炯		kíng
炰	pû	
炱	te	
炳	píng	
炸	tsà, tsuànn, tsia̍h	tshia, tsah
為	uī, uî	
烈	lia̍t	
烌	hu	
烏	oo, u	
烘	hang, hōng, hong	
烙	lō, lo̍k	
烤		khó
烰	phû	
烹	phing	
烽		hong
焐	ù	
焗	ko̍k	
焙	puē	pē
焚	hûn	
焠	tshuh	tshuì
無	bô, bû, --bô	
焦	ta, na, tsiau	tann
焰	iām	
焱	iānn	
然	jiân, liân	
煉	liān	
煌	hông	
煎	tsian, tsuann	
煏	piak	
煖		luán
煙	ian	
煞	suah, sannh, sat	
煠	sa̍h	sah, sā
煡	khi̍t	
煤	muê	
煥	huàn	
照	tsiàu, tsiò	
煨	ue	
煩	huân	
煬	iāng, iông	
煮	tsú	tsí
煽	siàn	
熁	hannh	hah
熄	sit	
熇	ho	
熊	hîm	
熏	hun	
熔	iûnn, iông	
熗	tshìng	
熙		hi
熟	si̍k, sio̍k	
熥	thn̄g, thang	lang, thuīnn
熨	ut	
熬	gô	
熱	jia̍t, jua̍h, lia̍t, lua̍h	juā
熹		hi
燃	hiânn, jiân, liân	
燄	iām	
燈	ting	
燉	tūn	
燒	sio	
燕	iàn, ìnn, ian	
燖	tīm	
燙	thǹg	
燜	būn	
營	iânn, îng	
燥	sò	
燦	tshàn	
燭	tsik, tsiok	
爁	nah	nà
爆	po̍k	
爍	sih	sinnh
爐	lôo	
爛	nuā, lān	
爪	jiáu, niáu, liáu	giáu
爬	pê	
爭	tsing, tsenn, tsinn	
爵	tsiok, tsik	
父	hū	
爸	pē, pah, pâ	pa, pá
爹	tia	
爺	iâ	
爻	ngâu	
爽	sóng, sńg	
爾	niā, nī	ní
爿	pîng	pîn
牆	tshiûnn	tshiông, tshiônn
片	phìnn, phiàn	
版	pán	
牌	pâi	
牒	tia̍p	
牘	to̍k	
牙	gê, gâ	
牚	thènn, thìnn	thì
牛	gû, giû	
牟	bôo	
牡	bóo	
牢	tiâu, lô	
牧	bo̍k	
物	mi̍h, mih, bu̍t, mn̍gh	mī, mí, mn̄g, bìn
牯		kóo
牲	sing, senn, sinn	
特	ti̍k	
牽	khan, khian	
犀	sai, se	
犁	lê	luê
犅	káng	
犒	khò	
犢	to̍k	
犧	hi	
犬	khián	
犯	huān	
狀	tsiōng, tsōng, tsn̄g	
狂	kông	
狄	ti̍k	
狎	a̍p	
狐	hôo	
狗	káu, kóo	
狡	káu	
狩		siù
狸	lî	
狹	e̍h, hia̍p, ue̍h	ē
狼	lông	liông
狽	puē	
猊	lî, jî	
猌	gīn	
猖	tshiong	
猛	mé, bíng	
猜	tshai	
猩	sing	
猫	bâ	
猴	kâu	
猶	iáu, iu, iû	á, iá, iah, ah
猾	ku̍t	
猿		uân
獄	ga̍k, gi̍k	
獅	sai	
獎	tsióng, tsiáng	
獠	liâu	
獨	to̍k, ta̍k	
獲		hi̍k
獵	la̍h, lia̍p	
獸	siù	
獺	thuah	
獻	hiàn	
玄	hiân	
率	lu̍t, sut	
玉	gio̍k, gi̍k	
王	ông	
玩	uán, guán	
玫	muî	
玲	lin, lîng, lîn	
玻	po	
珊	suan	san
珍	tin, tsin	
珞	lo̍k	
珠	tsu	
班	pan	
珮	puè	
現	hiān, hiàn	
球	kiû, khiû	
理	lí	
琉	liû	
琢	tok	
琦	kî	
琪	kî	
琳	lîm	
琴	khîm	
琵	pî	
琶	pê, pâ	
琺		huat
瑄		suan
瑋	uí	
瑕	hâ	
瑙	ló	
瑚	ôo	lôo
瑛	ing	
瑜	jû, lû, û	
瑞	suī, tsuí	
瑟	sik, sit	
瑠		liû
瑣	só	
瑤	iâu	
瑩	îng	
瑪	má, bé	
瑯	long, lông	
瑰	kuì	
璃	lê, lî	
璇	suān	
璋	tsiong	
璜		hông
璞	phok, phoh	
環	khuân, huân	
璿	suân	
瓊	khîng, khiông	
瓜	kue, kua	
瓠		pû, puî
瓢	phiô	
瓣	bān	pān
瓤	nn̂g, liông, jiông	nn̄g
瓦	hiā, uá	huā, hāu
瓶	pân	
瓷	huî	
甄	tsin	
甌	au	
甍	bòng	
甓	phia̍h	
甕	àng, pênn	
甘	kam	lam
甚	sīm	
甜	tinn	
生	sing, senn, sinn, tshenn, tshinn	
產	sán	
甥	sing	
甦	soo	
用	iōng, īng	
甪	lut	
甫	hú	
甭	bàng	
田	tshân, tiân, tiān	iân
由	iû	
甲	kah, kap	
申	sin	
男	lâm	
甸		tiān
町	ting	
界	kè, kài, kuè	
畏	uì	
畔	puān	
留	lâu, liû	
畚	pùn, pūn	
畜	thik, thiok	
畝	bóo	
畢	pit	
略	lio̍h, lio̍k	
番	huan, han	an
畫	uē	uī
異	ī	īnn
當	tàng, tng, tong, tang, tòng, tǹg	
疆	kiong	
疇		tiû
疊	tha̍h, thia̍p, thiap	
疏	soo, se, sòo	
疑	gî	
疔	ting	
疕	phí	
疤	pa	
疥	kè, kuè	
疧	khî	
疫	i̍k, ia̍h	
疱	phā	
疲	phî	
疳	kam	
疵	tshû	
疶	tshuah	
疸	thán	
疹	tsín	
疼	thiànn	
疾	tsi̍t, tsi̍k	
痀	ku	
病	pēnn, pīnn, pīng	
症	tsìng	
痔	tī	
痕	hûn	
痘	tōo, tāu	
痚	he	
痛	thàng, thòng	
痞	phí	
痟	siáu, siau	
痠	sng	
痡	pôo	
痢	lī	
痣	kì	
痧	sua	
痰	thâm	
痱	puì	
痲	muâ	mâ, bâ
痴	tshi	
痹	pì	
痺	pì	
痻		in, un, hun
瘋	hong	huang
瘍	iông	
瘟	un	
瘡	tshng, tshong	
瘤	liû	
瘦	sán, sóo	
瘰	luì	lí, bí
瘸	khuê, khê	khue
瘼	mo̍oh	mòo, mōo, mooh, nà
癀	hông	
療	liâu	
癆	lô	
癉	tan	
癌	gâm	
癖	phiah, phia̍h	phiā
癗	luî	
癜	tiō	tiò
癡	tshi	
癢	tsiūnn, ióng	tsiōnn
癧		la̍t
癩	thái	
癬	sián	
癮	giàn, ín	
癰	ing	
癲	tian	
癸	kuí	kuì
登	ting	
發	huat, puh, hua̍t	
白	pe̍h, pi̍k	pē, pue̍h
百	pah, peh, pik	
皂	tsō	
的	ê, --ê, tik, ti̍k	
皆	kai	
皇	hông	
皎		kiáu
皓	hōo, hō	
皙		sik
皮	phuê, phê, phî, pî	
皺	jiâu, liâu	
盃		pue
盆	phûn	
盈	îng	
益	ik, iah	
盍	khah	
盒	a̍p, a̍h	
盔	khue	
盛	sīng, siānn	
盜	tō	
盞	tsuánn, tsán	
盟	bîng	
盡	tsīn	tsìn
監	kàm, kann, kam	ka
盤	puânn, phuân, puân	
盦		âm
盧	lôo	
盪	tn̄g, tōng	
目	ba̍k, bo̍k	bui
盯		tìng
盲	mê, bông, môo, mî	
直	ti̍t	
相	sio, siong, siòng, sann, siùnn, siunn	siōng, siang, sionn, siu, siàng, siònn
盹	tuh	
盼	phàn	
盾	tún	
省	síng	
眉	bâi, bî	
看	khuànn, khàn, khuàn	
真	tsin	
眠	bîn, biân	mn̂g, mî
眨	tsha̍p	
眩	hîn	
眯	bî	
眵	tshuh	
眷	kuàn	
眼	gán, gíng	kíng, ngái
眾	tsiòng, tsìng	
着	tio̍h	
睏	khùn	
睚	kâinn	
睛	tsing	
睡	tsuē, suī	tsē
督	tok	
睦	bo̍k	
睨	gîn	gûn
睫	tsiah	tsia̍p
睭	tsiu	
睹	tóo	
睿		juē
瞅	tshiu	
瞌	kheh, ka, khueh	
瞞	muâ	
瞪	tènn, tìnn	
瞬	sùn	
瞭	liâu, lió, liáu	
瞳	tông	
瞻	tsiam	
瞿	khû	
矇	bông	
矛	mâu, môo	
矜	khim, king	
矢	sí	
矣	--ah	ah
知	tsai, ti	
矩	kí, kú	
短	té, tuán	
矮	é, ué	
矯	kiáu	
石	tsio̍h, si̍k, sia̍h, si̍h	tsiō, siā
矸	kan	
砂	sua, se	
砃		tan
砉	huah	
砌	kih	
砍	khám	
砒	phi	phînn
研	gián, gíng	ngái, nguí, gán
砛	gîm	
砣		tôo, tô
砧	tiam	
砰		phing
砲	phàu	
破	phuà, phò	
硃	tsu	
硐	tōng	
硓	lóo	
硝	siau	
硞	kho̍k, khok	
硩	teh	
硫	liû	
硬	ngē, ngī, gīng	
硯	hīnn	
硼	phîng	pîng
硿	kńg	
碇	tiānn, tīng	tiànn
碉		tiau
碌	lo̍k, li̍k	
碎	tshuì	
碑	pi	
碓	tuì	
碖	lún	
碗	uánn	uáinn
碟	tia̍p, ti̍h	
碡	ta̍k	
碣	khat, khiat	
碧	phik	
碩	si̍k, sik	
碭	thn̄g	
碰	pōng, phòng	
碳	thuànn	
確	khak, khia̍k	
碼	bé, má	
碾	lián	
磁	tsû	
磅	pōng	phóng
磊	luí	
磋	tsho	
磐	puânn, phuân	
磕	kha̍p	
磚	tsng, tsuan	tsuinn
磟	la̍k	
磨	buâ, bō, môo	
磯		ki
磺	hông	n̂g
礁	ta, tann, tsiau	
礎	tshóo	
礐	ha̍k	
礓		kiang
礙	gāi	ngāi
礤	tshuah	
礦	khòng	
礪	lè	
礫		li̍k
礬	huân	
礱	lâng	
示	sī	
社	siā	
祀	tshāi, sū, sāi	
祈	kî	
祉	tsí	
祐	iū	
祕	pì	
祖	tsóo	
祚	tsà	
祛		kiā
祝	tsiok	
神	sîn	
祟	sui, suī	
祠	sû, sī	
祥	siông	
祧	thiāu	
票	phiò, phiàu	
祭	tsè	
祹		tô
祺	kî	
祿	lo̍k	
禁	kìm	
禍	hō, ē	
禎	tsing	
福	hok	
禦	gū	
禧	hi	
禪	siân, siān	siâm
禮	lé	
禱	tó	
禹	ú	
禽	khîm	
禾	hô	
禿	thuh, thut	
秀	siù	
私	su, sai, si	
秉	píng	
秋	tshiu	tshio
科	kho	
秒	bió, biáu	
秘	pì	
租	tsoo	
秤	tshìn, pîng	
秦	tsîn	
秧	ng, iong, iang	
秩	tia̍t	
秪	te	
秫	tsu̍t	
秮	tai	
移	î	
稀	hi	
稅	suè, sè	
稈	kuáinn	kuínn
程	tîng, thîng, thiânn	
稗	phuē, phē	
稚	tī	
稜	lîng, līng	
稟	pín	
稠	tiû	khit
種	tsióng, tsíng, tsìng, tsiòng	
稱	tshing	
稷	tsik	
稻	tiū, tō	
稼		kà
稽	khe	
稿	kó	
穀	kok	
穆	bo̍k	
穌	soo	
積	tsik	
穎	ínn	
穗	suī, bué	
穡	sit, sik	
穢	uè, è	
穩	ún	
穫	hi̍k	
穴	hia̍t	
究	kiù	
穹	kiong	
空	khang, khong, khòng, khàng	
穿	tshīng, tshng, tshuan	tshuinn, tshiōng
突	tu̍t	thu̍t
窄	tsik	
窈	iáu	
窒	that	
窕	thiáu	
窗	thang, tshong	
窘	khún	
窞	thām	
窟	khut	
窣	su̍t	
窩	o	
窮	khîng, kîng, kiông	khing
窯	iô	
窵	tiàu	
窸	sī, si, si̍h	
窺	khui	
竄	tshuàn	tshǹg
竅	khiàu, khiò	
竇	tōo	
竊	tshiap, tshiat	
立	li̍p	
站	tsām	
竟	kìng	
章	tsiong, tsiunn	tsionn
童	tâng, tông	
竭	kia̍t	
端	tuan, tuann	
競	kīng	kìng
竹	tik, tiok	
竺	tiok	
竿	kan, kuann	
笆	pa	
笈	ki̍p	
笊		tsuá
笑	tshiò, siàu, tshiàu	
笒	giám, gím	
笙	sing	
笛	ta̍t, ti̍k	
笠	le̍h, li̍p, lue̍h	lē
符	hû	
笨	pūn, pùn	
第	tē	
笱	kô	
筅	tshíng	tsháinn, tshán
筆	pit	
等	tán, tíng	
筊	kiáu	
筋	kin, kun	
筍	sún	
筐	khing, khong	
筒	tâng, tông	
答	tap, tah	
策	tshik	
筠	ûn	
筧	khiò, kíng, kián	
筩		thāng
筵	iân	
箅	pín	
箋	tsian	
箍	khoo	
箏	tsing	
箔	po̍h	
箕	ki	
算	sǹg, suàn	suìnn
箠	tshuê, tshê, suî	
管	kuán, kóng, kńg	kuínn
箬	ha̍h	
箭	tsìnn, tsiàn	
箱	siunn, siong	sionn
箴	tsim	
箸	tī, tū	
節	tseh, tsat, tsiat, tsueh	
範	pān, huān	
篇	phinn, phian	
築	tio̍k	
篋	kheh	
篙	ko	
篠	siáu, siāu	
篡	tshuàn	
篤	táu, tok, tauh	
篦	pìn	
篩	thai	
篱	lē, luē	lî
篷	phâng, pông, hông	phông
篾	bi̍h, bia̍t	bī
簇	tshok	
簡	kán	
簪	tsiam	
簫	siau	
簷	tsînn, liâm	
簸	puà	puànn
簽	tshiam	
簾	lî, nî, liâm	
簿	phōo, pho̍k	
籃	nâ, lâm	
籌	tiû	
籍	tsi̍k	
籐	tîn	
籗	khah	
籠	láng, lam, lông, lâng, lāng, lang, lóng	
籤	tshiam	
籬	lî	
籮	luâ, lô	
籲	io̍k	
米	bí	
粅	but	
粉	hún	
粒	lia̍p	
粕	phoh, phok	
粗	tshoo	thoo, tshio
粘		liâm
粞	tshè, tshuè	
粟	tshik, siok	
粧	tsng, tsong	
粩	láu	
粱	liâng	liông
粹	tshuì	
粽	tsàng	
精	tsing, tsiann, tsinn	
粿	kué, ké	kue
糊	kôo, hôo	
糋	tsìnn	
糍	tsî	
糕	ko	
糖	thn̂g	
糙	tshò	
糜	muê, bê, mi	muâi, mai
糝	sám	
糞	pùn, hùn	
糟	tsau	
糠	khng, khong	
糧	niû	niôo
糰		thuân
糴	tia̍h, ti̍k	tiā, tia̍k
糶	thiò, thiàu	
系	hē	
糾	kiù	
紀	kì, kí, khí	
紂	tiū	
約	iok	
紅	âng, hông	â
紋	bûn	
納	la̍p	
紐	liú	
純	sûn	
紗	se, sa	sua
紙	tsuá	
級	kip	
紛	hun	
素	sòo	
紡	pháng, hóng	
索	soh, sik	
紩	thīnn	
紫	tsí	
紬	thiu	
紮	tsah, tsat, tsap	
累	luī, luí	
細	sè, suè	
紲	suà	
紳	sin	
紹	siāu	
紺	khóng	
紽		tô
終	tsiong	
絃	hiân	
組	tsoo	
絆	puànn, puàn	
結	kiat, kat	
絕	tsua̍t, tse̍h	
絚	ân	
絞	ká, káu	
絡	le, lo̍k, lo̍h	
絢	hiàn, sûn	
給	kip	
絨	jiông, liông	
絪	in	
絮	sù	
統	thóng	
絲	si	
絳	kòng	
絹	kìn	
綁	páng	
經	king, kenn, kinn	
綜	tsong, tsòng	
綠	li̍k, lio̍k	
綢	tiû	
維	uî, î	
綰	kuānn	
綱	kong	
網	bāng, bóng	
綴	tuè, tè, tuat	tsuè
綵	tshái	
綸	kuan, lûn	
綹	liú	
綺	khí	
綽	tshiok	
綾	lîng	
綿	mî, biân	
緊	kín	
緒	sū	sû
線	suànn	siàn
緝	tsi̍p, tship	
緞	tuān	
緟	thōng	
締	tè	
緣	iân	
編	pian, pinn	
緩	uān	
緬		bián
緯	uī	huī
練	liān	
緻	tì, tī	
縋	luī	
縐	tsò	
縒	tsua̍h	
縖	hâ	
縛	pa̍k	
縣	kuān	kuīnn, kuāinn
縫	phāng, pâng, hông	
縭	li, lî	
縮	sok, siok	
縱	tshióng, tshiòng, tshiong	
總	tsóng, tsáng	
績	tsik, tseh	
繁	huân	
繃	penn, pinn	
繆	biū	
繏	sǹg	
繐	sui	
織	tsit	
繚	liāu	
繞	jiàu, liàu	
繡	siù	
繩	tsîn, sîng	
繪	huē	
繫	hē	
繭	kián, kíng	kán
繳	kiáu	
繼	kè	
續	sio̍k	
纏	tînn, tiân	
纓	inn, iann, ing, enn	
纖	siam	tshiam
纜	lám, lām	
缸	kng, kong	
缺	khih, khueh, khuat, kheh	
缽	puah, puat	
缾		phiann
罅		hà
罈	thâm	
罐	kuàn	
罔	bóng	
罕	hán	
罟	koo	
罨	am	lam
罩	tà, tàu	
罪	tsuē, tsē	
置	tì	
罰	hua̍t	
署	sú, sū	
罵	mē, mā, má, mâ	mī
罷	pā	
罾	tsan	
羅	lô, ló	
羊	iûnn, iông	iônn
羌	kiunn, kiong	kionn
美	bí, bué, bé, bi	
羓	pa	
羔	ko	
羞	tshiu, siu	
群	kûn	
羨	siān	
義	gī	
羯	kiat	
羲		hi
羶	hiàn	
羹	kenn, kinn, king	
羽	ú	
翁	ang, ong	iang
翅	tshì	
翎	līng	
習	si̍p	
翔	siông	
翕	hip	
翟	ti̍k	
翠	tshuì	
翡	huí	
翦		tsián
翩	phian	
翰	hān	
翱	kō	
翳	ì, è	
翸	phún	
翹	khiàu	
翻	huan	
翼	si̍t, i̍k	
耀	iāu	
老	lāu, láu, ló, nóo, lōo	
考	khó	khónn
者	tsiá	
耆	kî	
而	jî, lî	
耍	sńg	
耎	luán	juán
耐	nāi	
耕	king	
耗		hònn
耘	ûn	
耙	pê, pē	
耞	kínn, kénn	
耳	hīnn, hī, ní	jí, mí, jínn
耶	iâ	
耽	tânn	tam
耿	kíng	
聆	lîng	
聊	liâu	
聖	sìng, siànn	
聘	phìng	
聚	tsū	
聞	bûn	
聬	áng	àng
聯	liân	
聰	tshong	
聲	siann, sing	
聳	tshàng, sáng	
聶	lia̍p	
職	tsit	
聽	thiann, thìng, thing	
聾	lâng, lông	
聿	u̍t	
肅	siok	
肆	sù	
肇	tiāu	
肉	bah, jio̍k, lio̍k, hi̍k	
肋	li̍k	
肌	ki	
肓	bông	hông, hong
肖	siàu	
肘	tiú	
肚	tóo, tōo	
肛	kong	
肝	kuann, kan	
股	kóo	
肢	ki	
肥	puî, huî	
肨	hàng	
肩	king, kian	
肭	leh	
肯	khíng	
肱	kong	
育	io, io̍k	
肴	ngâu	
肺	hì	
胃	uī	
背	puē, puè	
胎	thai, the	
胖	phàng	
胘	kiān	
胚	phue, phe	
胛	kah	
胞	pau	
胡	hôo, ôo	
胭	ian	
胮	hàng	
胰	î	i
胱	kong	
胳	koh	kueh, kuih
胴	tâng	lang, tang
胸	hing, hiong	
能	lîng	
胿	kui, kuai	kuainn
脂	tsi	
脅	hia̍p	
脆	tshè, tshuì	tshuè
脇		hia̍p
脈	me̍h, bi̍k	be̍h, mē, meh, bē
脊	tsiah, tsit, tsik	
脣	tûn	
脫	thuat, thu̍t, thut, thuah	
脬	pha	
脯	póo	pôo
脰	tāu	
脹	tiùnn, tiòng	tiònn
脽	tsui	
脾	pî, phî	
腋	i̍k	
腌	a	am
腎	siān, sīn	
腐	hū, hú	
腑	hú	
腔	khiunn, tshiunn, khiong, khiang	khionn, tshionn
腕	uánn, uán	
腡	lê	
腥	tshenn, tshènn, tshinn, tshìnn	tshe
腦	náu, ló, nóo	
腩	lám	
腫	tsíng	
腮	tshi	
腯		thún
腰	io, iau	
腱	kiàn, kiān	
腳	kioh, kha, kiok	
腴		jû
腸	tn̂g, tshiâng, tiông, tshiân	liông
腹	pak, hok	bak, bat, pat, phat
腿	thuí	
膀	phông	pông
膁	liám	
膈	keh	
膋	lâ	
膎	kê, kuê	
膏	ko, kô, koo	kō
膚	hu	
膜	mo̍oh	
膝	sit, tshik	
膠	ka	
膣	tsi	
膨	phòng	
膩	jī, lī	
膭	kuī	
膳		siān
膽	tánn, tám	
膿	lâng, lông	
臁	liâm	
臂		pì
臆	ioh, ik	ip
臉	lián, liám	
臊	tsho, tshau	
臍	tsâi, tsê	
臏		pīn
臘	la̍h, lia̍p	
臟	tsōng, tsn̄g	
臢	tsa	tsam
臣	sîn	
臥	ngōo	
臧	tsong	
臨	lîm, lím	liâm
自	tsū	
臭	tshàu	
至	tsì	
致	tì	
臺	tâi	
臼	khū	
舀	iúnn	iónn, ió
舂	tsing	
舅	kū, kiū	
與	ú, í	ū
興	hing, hìng, hin	
舉	kí, kú	
舊	kū, kiū	
舌	tsi̍h, sia̍t	tsī
舍	sià	
舐	tsīnn, tsn̄g	tsī
舒	tshu, su, soo	tshi
舖	phòo	
舜	sùn	
舞	bú	
舟	tsiu	
舢	sam	
舨	pán	
航	hâng	
般	puann, pan	puan
舵	tāi, tuā, tō	
舷	hiân	
船	tsûn	
舺	kah	
艇	thíng	
艋	báng	
艙	tshng, tshong	
艚	tsô	
艦	lām, kàm	
良	liông	
艱	kan	
色	sik	
艷	iām	
艾	ngāi, hiānn	
芋	ōo, ū	
芍	tsiok	
芎	kiong	
芒	bông, bâng	bang
芙	phû, hû	
芝	tsi	
芟	sing, san	sng
芡	khiàn, khiàm	
芥	kuà, kài, kè	
芫	iân	ian, uan, uân
芬	hun	
芭	pa	
花	hue, hua	
芳	phang, hong	
芷	tsí	
芸		ûn
芹	khîn, khûn	
芽	gê, gâ	bê, lê
苑	uán	
苒	liâm, jiâm	
苓	lîng	
苔	thî, thai	tî
苗	biâu, miâu	
苛	khô, kho	
苞	pôo, pau	
苟	kóo	
若	nā, ná, lio̍k, jio̍k	ā, lō
苦	khóo, ku	
苧	tuē, tē, thú	
英	ing	
苳	tang	
苴	tsū	
苻	hû	
茂	bōo, ōm	ām
范	huān	
茄	ka, kiô	
茅	hm̂, mâu	m̂
茈	tsínn	
茉	bua̍h, ba̍k	
茫	bông, bâng	
茭	ka, kha	
茯	ho̍k	
茱	tsu	
茲		tsu
茵	in	
茶	tê, te	tshâ
茸	liông, jiông	
荀	sûn	
荇	hīng	
草	tsháu, tshó	
荊	king	
荍	siô	
荏	lám	
荐	tsiàn	
荒	hng, hong	huinn
荔	nāi	lē, lāi
荖	láu, ló, lāu	
荳	tōo	
荷	hô, huê, hâ	hoo, hû, hûn, hôo
荽	sui	suinn
莆		pôo, hú
莉	nī	lī
莊	tsng, tsong	
莎	so, sa	
莒	kí	
莓	m̂, muî	
莖	huâinn, king	huînn
莢	ngeh	kueh, ngueh, gueh
莧	hīng	hāng
莫	mài, bo̍k, bo̍h	
莽	bóng	
莿	tshì	
菁	tshenn, tshinn, tsing	
菅	kuann	kan
菇	koo	
菊	kiok, kak	
菌	khún	
菖	tshiong	tshiang
菜	tshài	
菝	pua̍t, pa̍t	pu̍t
菠	pe, pue, po	
菡		hâm
菩	phôo	
華	huâ, hua, huà, kah	
菱	lîng	
菲	huí, hui	
菽		siok
萄	tô	
萊	lâi	
萍	phîng	
萎	ui, uí	
萣	tiānn	
萬	bān, báng	
萱		suan
萵	e, ue	meh, o
萼		go̍k
落	lo̍h, làu, lak, lo̍k, la̍uh, loh, --lo̍h	lōo, lāu, lō
葆		pó
葉	hio̍h, ia̍p	
著	tio̍h, to̍h, tù, --tio̍h, tio̍k	tiō, tō
葛	kat, kuah	
葡	phû	phô, pô, pû, phuê
董	táng, tóng	
葩	pha	
葫	hôo, ôo	
葬	tsòng	
葵	khuê, kuî	khue
蒂	tì	
蒔		sî
蒙	bông	
蒜	suàn	
蒲	pôo	
蒸	tsing	
蒼	tshong	
蒿	o	
蓁	tsin	
蓄	hak, thiok	
蓆	tshio̍h	tshiō
蓉	iông	
蓋	kài, kuà, kah, kap	
蓑	sui	
蓪	thong	
蓬	phōng, pōng, hông	
蓮	liân, lian, lián	lân, liám, nâi
蔀		pōo
蔑	bia̍t	
蔓	muā, bān	
蔔		po̍k
蔗	tsià	
蔚	uì	
蔡	tshuà	
蔣	tsiúnn	tsiónn
蔥	tshang	
蔫	lian	
蔬	se, soo	
蔭	ìm, ńg	
蔽	pè	
蕃	han, huan	
蕉	tsio, tsiau	
蕊	luí	
蕎	giō	kiō, kioh, jiō
蕗	lōo	lā, nōo
蕘	giô	
蕙		huī
蕨	kueh	keh, kuè, kè
蕩	tōng, tn̄g	
蕪		bû
蕭	siau, sio	
蕳		kan
蕹	ìng	
蕾	lê, luí	
薁	ò	
薄	po̍h, po̍k	pō
薅	khau	
薇	bî	
薈	huē	
薏	ì	
薐	lîng	
薑	kiunn	kionn
薔	tshiûnn	
薛	sih	
薟	hiam	hiang
薦	tsì, tsiàn	
薩	sat	
薪	sin	
薯	tsî, tsû	
薰	hun	
薸	phiô	
薺	tsî	
藃	hiauh	hiau
藉	tsik, tsioh, tsiah	
藍	nâ, lâm	
藏	tshàng, tsông, tsōng	
藐	biáu	
藕	ngāu	ngóo
藝	gē	
藤	tîn, tîng	
藥	io̍h, io̍k	iō
藩	phuan, huan	
藹	ái	
藺	līn	
蘆	lôo	
蘇	soo	
蘊	ùn	
蘋	phông, phōng	phîng
蘑	môo	
蘭	lân, liân, lán	lian
蘿		lo̍k, lô
虎	hóo, hu	
虐	gio̍h, gi̍k, gio̍k	
虔	khiân	
處	tshú, tshù	
虛	hi, hu	
虜	lóo	
虞	gû	
號	hō, lō	
虧	khui	
虫		huí
虯	khiû	
虱	sat	
虹	khīng	hông
虼	ka	
蚊	báng, bûn	
蚋	lā, la̍k	
蚌	pāng	bāng
蚓	kún	ún, kín, lún
蚣	kang	
蚤	tsáu	
蚵	ô	
蚶	ham	
蚻	tsua̍h	tsuā
蛀	tsiù, tsù	
蛄	koo	
蛆	tshi, tshu	
蛇	tsuâ, siâ	
蛉		nih
蛋	tàn, tuann	lua, nua
蛙	ua	kuê
蛚		le, lē
蛛	tu	
蛟	kau	
蛣		kiat
蛤	kap	
蛹		ióng
蛻	thuì	
蛾	ia̍h	
蜀	sio̍k	
蜂	phang, hong	
蜃		sīn
蜅	poo	koo
蜈	giâ, ngôo, gôo	môo
蜊	lâ	lâi
蜍	tsî	tsû
蜘	ti	
蜜	bi̍t	
蜞	khî	
蜢	meh	nih, neh, ni
蜣		kiunn
蜷	khûn	
蝒	bīn	gūn, būn
蝕	si̍h, sit, si̍k	sī, si̍t
蝙		pián
蝛	bui	ui
蝝	iân	
蝟		uī
蝠		hok
蝦	hê	
蝨	sat	
蝴	ôo, hôo	
蝶	ia̍h, tia̍p	iā
蝹	un	
蝻	lâm	
螂		lâng, bông
融	iông, hiông	
螕	pi	
螟	bîng	
螢	îng, hîng	
螳		tông
螺	lê, lôo	
螿	tsiunn	tsionn, tsiong
蟀	sut	suì
蟄	ti̍t	
蟊		moo
蟋	sih, sik	tik
蟒	bóng, báng	
蟧	lâ	
蟬	siân	
蟮	siān	sīn, sîn, sin
蟯	ngia̍uh, giô, liâu, jiâu	
蟲	thâng, thiông	âng, tâng, lâng
蟳	tsîm	
蟶	than	
蟹	hē, hāi	huē, heh
蟻	hiā, gí	
蟾	siâm	
蠅	sîn	
蠍	giat	
蠐	tsê	tshê
蠓	báng	
蠕	lû, lùn, jû	
蠘	tshi̍h	
蠟	la̍h, la̍p	
蠢		tshún
蠳		ni
蠶	tshâm, thâm, tshân	
蠻	bân	
蠽		tsua̍h, tsuā
血	hueh, huih, hiat	
行	kiânn, hîng, hâng, hīng, lîng	nn̄g
衍	ián	
術	su̍t	
街	ke, kue	
衙	gê	
衛	uē, ué	uī
衝	tshiong, tshóng, tshìng	
衡	hîng	
衣	i, ui	
表	piáu, pió	
衫	sann	
衰	sue	sui
衲	la̍p	
衷	thiong	
袁	uân	
袂	bē, buē	
袈	ka	
袋	tē, tāi	
袍	phâu	
袖	siù	
袚	phua̍h	
被	phuē, phē, pī	
袱	ho̍k	
裁	tshâi	
裂	li̍h, lia̍t, liah	
裊		niáu
裌	kiap	
裏	lí	
裒	pôo	
裔	è, ì	
裕	jū, lū	
裘	hiû	
裙	kûn	
補	póo	
裝	tsong, tsng	
裟	se	
裡	lí, --lí, --nih	
裱	piáu	
裴	puê	
裹	kó	
裼	theh	thueh
製	tsè	
裾	ki, ku	
褂	kuà	
複	ho̍k	
褒	po	
褙	puè, pè	
褚	thú	
褥	lio̍k, jio̍k	
褪	thǹg	thuìnn
褫	thí	
褲	khòo	
襀	tsioh	
襄	siong	
襇	kíng	kán
襞	phé	
襟	khim	
襤	lâm	
襪	bue̍h, bua̍t	be̍h, buē
襲	si̍p	
襻	phàn	
西	se, sai, si	sie
要	iàu, iau	á
覆	phak, hok	
見	kiàn, kìnn, --kìnn	
規	kui	
覓	māi, bā, bi̍k	buâ, buā
覕	bih	
視	sī	
親	tshin, tshinn, tshenn	tshan, tshing
覲		kīn
覷		tshuh
覺	kak	
覽	lám	
觀	kuan, kuàn	
角	kak	
觔		kun
解	kái, ké	
觱	pi	
觳	khok	kho̍k, khóo, phok
觸	tak, tshiok, tshik	ta̍k, sio̍k, táu
言	giân	gân
訂	tīng	
訃	hù	
計	kè, kì	khè, khì
訊	sìn	
討	thó	
訓	hùn	
訕	suān	suan
託	thok	
記	kì	
訟	siōng	
訣	kuat	
訪	hóng	
設	siat	
許	khóo, hí, hú	
訴	sòo	
訶		honn
診	tsín	
註	tsù	
詈	lé, lué	
詐	tsà	
詔	tsiàu	
評	phîng	
詞	sû	
詢	sûn	
詣	gē	
試	tshì	
詩	si	
詬	kāu	
詭	kuí, khuí	
詮	tshuan	
詰	khiat	
話	uē	
該	kai	
詳	siông	siâng
詹	tsiam	
詼	khue, khe	
誅		tu
誇	khua	
誌	tsì	
認	jīn, līn	
誓	tsuā, sè, sē	
誕	tàn, tān	
誘	iú	
語	gí, gú	
誠	tsiânn, sîng	
誡	kài	
誣	bû	
誤	gōo	ngōo
誦	siōng	
誨		huè
說	sueh, suat, seh, suè	
誰	tsuî, suî	tiâng, tsiâ, tsuī, siâng
課	khuè, khò	khè
誹	huí	
誼	gî, gī	
調	tiāu, tiâu, tiàu, tiau, thâu	
談	tâm	
請	tshiánn, tshíng	
諍	tsènn, tsìnn, tsìng	
諒	liōng	
論	lūn	
諜	tia̍p	
諞	pián	
諦	tè	
諧	hâi	
諭	lū, jū	
諮	tsu	
諱		huì
諳	am	
諷		hóng
諸	tsu, ti	
諺	gān	
諾	lo̍k, --hioh, hioh	hànn
謀	bôo, biô	môo
謂	uī	uì
謄	thîng	
謊	hong, hóng	
謎	bī	bē, bî
謔	gio̍h, giok	
謗	pòng	
謙	khiam	
講	kóng, káng	
謝	siā, tsiā	
謠	iâu	
謬	biū	
謳	oo	
謹	kín	
謼	hooh	
譀	hàm	
譁	huā	
證	tsìng	
譎	khiat	
譏	ki	
識	sik	
譚	thâm, tâm	
譜	phóo	
警	kíng	kìng
譬	phì	
譯	i̍k	
議	gī	
譴	khiàn, khián	
護	hōo	lōo
譽	ū	
讀	tha̍k, tho̍k, tāu, tōo	
變	piàn, pìnn	
讓	niū, liōng, jiōng	niōo
讖	tshàm	
讚	tsàn, tsán	
谷	kok	
豆	tāu	
豈	khí	
豉	sīnn	sī
豋		ting
豍	pi	
豎	sū	
豐	hong, phong	
豔	iām	
豚	thûn	
象	siōng, tshiūnn, siūnn, siòng, sióng	sīn, siōnn, tshiōnn
豪	hô	
豫	ū	
豬	ti, tu	
豸	thuā	
豹	pà	
貂	tiau	
貉	hô	
貌	māu	
貓	niau, bâ, bâu	
貝	puè	
貞	tsing	
負	hū	
財	tsâi	
貢	kòng	
貧	pîn	pân, pûn, pān
貨	huè, hè, hònn, hò	
販	huàn, phuànn	phuà
貪	tham	
貫	kǹg, kuàn	kuìnn
責	tsik	
貯	té, tué, thú	
貳	lī, jī	
貴	kuì	
貶	pián	
買	bé, bué, mái	
貸	tāi	
貺	hīng	hān
費	huì, pì	
貼	tah, thiap	tia̍p
貿	bāu, bōo	ba̍uh
賀	hō	
賂	lōo	
賄	hué	
資	tsu	
賈	kóo, ká	
賊	tsha̍t, tsa̍t, tsi̍k	
賑	tsín	
賒	sia	
賓	pin	
賜	sù	
賞	siúnn, sióng	siónn
賠	puê, pê	
賢	hiân	
賣	bē, buē, māi	
賤	tsiān	
賦	hù	
質	tsit	
賭	tóo	
賰	tshun	
賴	luā, nāi, lē	lāi
賺	tsuán	
購	kòo, káng	
賽	sài, sè, sái	
贅	tsuè	
贈	tsīng	
贊	tsàn, tsān	
贌	pa̍k	
贏	iânn, îng	
贐	tsīn	
贓	tsong, tsng	
贖	sio̍k	
赤	tshiah, tshik	tsiah
赦	sià	
赫		hik
走	tsáu, tsóo	
赴	hù	
起	khí, ki	
趁	thàn	
超	tshiau, thiau	
越	ua̍t	
趒	tiô	
趕	kuánn, á	
趖	sô	
趙	tiō	
趣	tshù	
趨	tshu	
足	tsiok	tsok
趺	u	hu
趼	lan	
趾	tsí	
跂	kué, ké	
跋	pua̍h, pua̍t	puā
跌	tia̍t	
跍	khû	
跎	tô	
跑	pháu, phâu	
跔	ku	
跕	liam	
跙	tshū	
跛	pái	páinn
距	kū, kī	
跟	kin, kun	
跡	jiah, liah, tsiah, tsik	
跤	kha	kau
跨		khuà
跩	tsuāinn	
跪	kuī	
路	lōo	
跳	thiàu	
踃		sau
踅	se̍h	
踏	ta̍h, ta̍p	tā
踐	tsiān	
踔	tshi̍k	
踢	that, thah, thik	
踩	tshái	
踮	tiàm	tàm
踴	ióng	
蹁	phîn	phiân
蹄	tê, tuê	
蹈	tō	
蹉	tsho	
蹊	khi	
蹌	tshiáng	tshíng
蹓	lau	
蹔	tsàm	
蹘	liâu	
蹛	tuà	
蹟	tsik	
蹤	tsong	
蹧	tsau	tsiau
蹬	tenn, tinn	
蹲	tsun	
蹺	khiau	
蹽	liâu	
躁		sò
躂	that	
躄	phih	phī
躇	tû	
躊	tiû	
躍	io̍k	ik
躘	liòng, lìng	
躡	neh, nih	
身	sin, sian	sing, siang, hun
躬	kiong	
躼	lò	liò
躽	nuà	
軀	khu, su	siu
軁	nǹg, nng	nuì
車	tshia, ki, ku, tshâ	
軋	kauh	
軌	kuí	
軍	kun	
軒	ian, hian	
軟	nńg, luán	nuí
軸	ti̍k	
較	khah, kàu, kà, kah	
載	tsài, tsáinn	
輓	buán	
輔	hú, phóo	
輕	khin, khing	
輛	lióng, liōng	
輝	hui	
輦	lián	lín
輩	puè	
輪	lûn, lián, lin	lian, lín, lún
輯	tsi̍p, tship	
輸	su	
輻	hok	
輾	liàn, tián	lìn
轄	hat	
轆	lak, lo̍k	
轉	tńg, tsuán, tsuān	tuínn
轍	tia̍t	
轎	kiō, kiau, kiāu	kioh
轟	hong	
辛	sin	
辜	koo	
辟	phiah, phik	
辣	lua̍h	la̍h, luā
辦	pān	
辨	piān	
辭	sî, sû	
辮	pīnn	
辯	piān	
辰	sîn	
辱	jio̍k, lio̍k	
農	lông	
迅	sìn	
迌	thô	
迎	ngiâ, gîng, giâ	
近	kīn, kūn	
迒	hānn	hâ
返	tńg, huán	
迢		tiâu
迦	khia	kia, kiau, khiau
迪	ti̍k	
迫	pik	
迭	tia̍t	
述	su̍t	
迴	huê	
迵	thàng	
迷	bê	
迸	piàng	
追	tui	
退	thè	thuè
送	sàng, sòng	
逃	tô	
逆	gi̍k	
逍	siau	
透	thàu, thò	
逐	ta̍k, jiok, lip, tio̍k	jik, jip, tsip, giok
途	tôo	
逕		kìng
這	tsit, tse	tsiàng, tsiah
通	thang, thong	
逝	tsuā	sē
逞	thíng	
速	sok	
造	tsō	
逢	hông	
連	liân, liâm, nî	
逮	tāi	
週	tsiu	
進	tsìn	
逸	i̍k, iat, i̍t	ia̍t
逼	pik	piat
遁	tūn	
遂	suī	
遇	gū	bū
遊	iû	
運	ūn, īn, ùn	
遍	piàn, phiàn	
過	kuè, kè, koh, kò, kuà, kòo, --kè, --kuè	kù
遏	at	
遐	hia, hiah, hiâ	hiô
道	tō	
達	ta̍t, ta	
違	uî	
遙	iâu	
遛	liù	
遜	sùn	
遞	tē	
遠	hn̄g, uán	huīnn
遣	khián	
遨	gô, ngôo	
適	sik	
遭	tso	
遮	tsia, tsiah, jia, lia	tsiâ, tsiô, gia
遲	tî	
遴	lîn	
遵	tsun	
遷	tshian	
選	suán	
遹	u̍t	
遺	uî, i	
遼	liâu	
避	pī, phiah	
邀	iau, io	
邁	māi	
還	hîng, huān, huân	hân, hâinn
邊	pinn, pian	
邏	lô	
邑	ip	
那	ná	
邦	pang	
邪	siâ	
邱	khu	
邵	siāu, siō	
邸	tí	
郁	hiok	
郊	kau	
郎	lông, nn̂g, lang	
郝	hok	
郡	kūn	
部	pōo, phō	
郭	kueh, kok	keh
郵	iû	
都	to, too	
鄉	hiong, hiunn	hionn
鄒	tsoo, tsau	
鄔	oo	
鄙	phí	
鄧	tīng	
鄭	tēnn, tīng, tīnn	
鄰	lîn	
酆	hong	
酉	iú	
酋	siû	
酌	tsiok	
配	phuè, phè	
酒	tsiú	
酥	soo	
酪		lo̍k
酬	siû	
酵	kànn	kà
酷	khok	
酸	sng, suan	suinn, san
酺	pôo	
醃	am	âm, iâm, iam
醇	sûn	
醉	tsuì	
醋	tshòo	
醒	tshénn, tshínn, síng	
醜	tshiú	
醡	tsà	
醫	i, pīnn, pēnn	
醬	tsiùnn	tsiònn
醮	tsiò, tsiàu	
醴	lé	
釀	liōng, jiōng	
采	tshái	
釋	sik	
里	lí, lî	
重	tāng, tiōng, tîng, tiông	
野	iá	
量	liōng, niū, niû, liông	niōo, niō, niôo
釐	lî	
金	kim	
釘	ting, tìng	tan
針	tsiam	tsam, tsim
釣	tiò, tiàu	
釧	tshuan	
釵	the, tshai	
鈃	giang	
鈍	tūn, tùn, tun	
鈔	tshau	
鈕	liú	
鈗	ńg	uínn
鈞	kun	
鈣		bián
鈴	lîng	ling, liâng
鈷	kóo	
鈸	pua̍t, pua̍h	
鉈	tô	
鉎	sian	san
鉗	khînn, khiâm	
鉛	iân	
鉤	kau	
鉸	ka	
鉼	phiánn, pín	
銀	gîn, gûn	
銃	tshìng	
銅	tâng	
銎	khing	
銓		tshuan
銘	bîng	
銬	khàu	
銲	huānn	
銳	luē, juē	
銷	siau	
鋁	lū, lú	
鋉	sok	
鋏	giap	ngeh
鋒	hong	
鋟	tshím	tshìm, tshim
鋤	tî, tû	
鋩	mê, mî	
鋪	phoo	
鋸	kì, kù	
鋼	kǹg, kong	
錄	lo̍k, li̍k, lio̍k	
錐	tsui	
錘	thuî	
錚	tshānn	
錠	tīng, tiānn	
錢	tsînn, tshiân, tsiân	
錦	gím, gìm, kím	
錨	biâu, bâ	
錫	siah, sik	
錯	tshò, tshok	
錶	pió	
鍊	liān	liân
鍋	ue, ko, e	
鍍	tōo	
鍘	tsa̍h	
鍛	tuàn	thuàn
鍤	tshiah	
鍥	keh, kueh	
鍵	kiān	
鍼	tsiam	
鍾	tsing, tsiong	
鎈		tshenn, tsha
鎊	pōng	
鎔	iûnn	
鎖	só	
鎚		thuî
鎧		khái
鎮	tìn	
鏃	tso̍k	
鏘	tshiong	
鏡	kiànn	
鏢	pio	
鏨	tsām	
鏽	siù	
鐃	lâu, nâ	luâ
鐐	liâu	
鐕		tshâm
鐘	tsing, tsiong	
鐳	luî	lui
鐵	thih, thiat	
鑄	tsù	
鑑	kàm	
鑠	siak	
鑢	lù, luē, lē	
鑫	him	
鑰	io̍k, io̍h	
鑱	tshîm	
鑼	lô	
鑽	tsǹg, tsuàn	tsuìnn, tshǹg
鑾	luân	
鑿	tsha̍k, tsho̍k	
長	tn̂g, tiúnn, tióng, tiông, tshiâng, tsióng, tsiáng	tiónn
門	mn̂g, bûn	bîn, muî
閂	tshuànn	
閃	siám	
閉	pì	
開	khui, khai, --khui	
閏	jūn, lūn	
閒	îng, hân	
間	king, kan, kàn	
閔	bín	
閘	tsa̍h	
閣	koh, kooh	
閨		kui
閩	bân	
閬	làng, lòng	
閱	ua̍t, ia̍t	
閹	iam	
閻	giâm	
闆	pán	
闇	am	
闊	khuah	
闔	kha̍h, ha̍p	
闕	khuat	
闖	tshuàng	
關	kuan, kuainn, kuinn, kan	
闡	tshián	
闢	pi̍k	
阮	guán, ńg	gún, uínn
阱	tsínn, tsénn	
防	hông	
阻	tsóo	
阿	a, oo, o	
陀	lô, tôo, tô	
陂	pi	
附	hù, hū	
陋	lōo	
陌	bi̍k	
降	kàng, hâng	
限	hān, ān	
陛	pè	
陝	siám	
陞	sing	
陡		tóo
院	īnn	ìnn
陣	tsūn, tīn	sūn
除	tû, tî	
陪	puê	
陰	im, iam	lam
陳	tân, tîn	
陵	niā, lîng, lóng	
陶	tô	
陷	hām	
陸	lio̍k, la̍k, lo̍k	
陽	iông, iûnn, iâng	iônn, niû, muî
隄		thê
隅		gû
隆	lâng, liông	
隊	tuī	
隍	hông	
階	kai	
隔	keh, kik	
隕		ún
隘	ài	
隙	khiah	
際	tsè	
障	tsiong, tsiòng, tsiàng	
隧	suī	
隨	suî	
險	hiám	
隱	ún	
隴		lóng
隸	lē	
隻	tsiah, tsik	
雀	tshiok, tshik	
雁	gān	
雄	hiông, hîng	
雅	ngá, ngé	
集	tsi̍p	
雇	kòo	
雉	thī	
雌		tshu
雍		iong
雕	tiau	
雖	sui	
雙	siang	song, sang
雜	tsa̍p	
雞	ke, kue	
離	lī, li, lî	
難	lân, lān	
雨	hōo, ú	í
雪	sap, seh, suat, siat	
雯	bûn	
雲	hûn	ûn
零	lân, lîng	
雷	luî	
雹	pha̍uh	phàu, phau, phāu
雺	bông	môo
電	tiān	
需	su	
霄	siau	
霆	tân, tîng	
震	tsìn	
霍	hok	ho̍k
霎	sap, tiap	sa̍p
霓		gê
霖	lîm	
霜	sng, song	
霞	hê, hâ	
霧	bū, buh	
露	lōo, lo̍k	lòo
霸	pà	
霹	phik	
靂	li̍k	
靈	lîng	liân
青	tshenn, tshinn, tshing	
靖	tsīng	
靘		tshínn
靜	tsīng, tsēnn, tsīnn	
非	hui	
靠	khò, khuà	
面	bīn, biān	
革	kik	
靳	kìn	
靴	hia	
靶	pé	
鞅	ióng	
鞋	ê, uê, hâi	
鞍	uann, an	
鞏	khōng, kióng	
鞘	siù	siò
鞠	kiok	
鞦	tshiu	thiu
鞭	mi, pian, pinn	
韆	tshian	tshan, khan
韋	uî	
韌	jūn, lūn	
韓	hân	
韭	kú	
音	im	
韻	ūn	
響	hióng, hiáng	
頁	ia̍h	
頂	tíng	
頃	khíng, khing	
項	hāng	
順	sūn	
頇	hân, han	
須	su	
頌	siōng	
預	ī, ū	
頑	guân	
頒	pan	
頓	tǹg, tùn	tuìnn
頕	tàm	tìm, thìm
頗	phó	
領	niá, líng	
頡	khiat	
頦	hâi, huâi	
頭	thâu, thiô, thôo, thô	tha̍h
頷	ām	
頸	kún, kíng	
頹	tuê	
頻	pîn	
題	tê, tuê	
額	gia̍h, hia̍h, gi̍k	giā
顎	kok	khok, gok
顏	gân	
願	guān	
顛	tian, thian	
類	luī	
顢	bān	
顧	kòo	
顫	tsùn	
顯	hián, hiánn	
顱		lôo
顴	kuàn	
風	hong	huang
颱	thai	
颶		kū
颺	iānn, tshiûnn	tshiônn
飄	phiau	
飆	pio, phiau	
飛	pue, hui, hue, pe	
食	tsia̍h, si̍t	tsiā
飢	ki	
飫	uì	
飯	pn̄g, huān	puīnn
飲	ím	
飼	tshī	
飽	pá, páu	
飾	sik	
餃	kiáu	
餅	piánn	
餉	hiòng	
養	ióng, iúnn	iáng, iónn
餌	jī, lī	
餐	tshan	
餒	lué	
餓	gō	
餘	û, î	
餞	tsiàn	tsián, tsian
餡	ānn	
館	kuán	
餲	ai	
餾	liū, liû	
饅	bán, bân	
饋	kuī	
饌		tsuān
饑		ki
饒	jiâu, liâu	
饗	hiáng	
饞	sâi	
首	siú	
香	hiunn, hiong, hiang	hionn
馝	pih	
馨	hing, hiong	
馬	má, bé, ma	
馮	pâng	
馳	tî	
馴	sûn	
駁	pok, poh	phoh
駐	tū, tsù	tsū
駕	kà	
駙		hū
駛	sái, sú	
駝	tô	
駟		sù
駱	lo̍k, lo̍h	
駿	tsùn	
騎	khiâ, khî	
騙	phiàn	
騫		khian
騰	thîng	
騷	so	
騾		lê, lô
驅	khu	
驍	hiau	
驕	kiau	
驗	giām	
驚	kiann, kenn, king	kinn
驛	ia̍h, i̍k	
驢	lû, lî	
骨	kut	
骰	tâu	tāu
骱	kái	
骸	hâi	
骼	keh	
骿	phiann	
髓	tshué, tshé, tshuí	
體	thé, thái, thué	
高	ko, kau	
髡	khun	
髮	huat	
髻	kuè, kè	
鬃	tsang	
鬆	sang, song	
鬍	hôo	
鬖	sàm	
鬚	tshiu, su	
鬢	pìn	
鬥	tàu, tòo	
鬧	lāu, nāu	
鬮	khau	
鬱	ut	
鬻		io̍k
鬼	kuí	
魁	khue	
魂	hûn	
魄	phik	
魅	bī	
魍	báng	bóng
魎		lióng
魏	guī	
魑		lî
魔	môo	
魚	hî, hû, gû	
魠	thoh	thuh
魩	but	
魬	puánn	
魯	lóo, luh	
魴	hang	
魽	kam	
鮊		pha
鮑	pau, pāu	
鮕	koo	
鮘	tai	
鮡	thiâu	
鮢	tsu	
鮫	ka	
鮮	tshinn, sian, sián	
鮸	bián	
鯃		gôo
鯉	lí	lē
鯊	sua	
鯗	siúnn	siónn
鯧	tshiunn	tshionn
鯨		king, kiang
鯪	lâ	
鯮	tsang	
鯰	liâm	
鯽	tsit	
鰇	jiû, liû	
鰓	tshi	
鰗	hôo	
鰡	liu	
鰮	un	
鰱	liân	
鰲		gô
鰻	muâ	
鰾	piō	
鱈	suat	
鱉	pih, piat	
鱔	siān	
鱖	kè, kuè	
鱗	lân, lîn	
鱙	liâu, jiâu	
鱟	hāu	
鱲	la̍h	
鱷	kho̍k	go̍k
鱸	lôo	
鱺	lē	
鳥	tsiáu, niáu	
鳩	khiu	
鳳	hōng	
鳴	bîng	
鴆	thim	
鴉	a	
鴒	līng	
鴕	tô	
鴛	uan	
鴞	hio̍h	hiō, hiau
鴟	tshi, lāi, bā	ba̍h, lā, muā, nā, na̍h
鴣	koo	
鴦	iunn, iong	ionn
鴨	ah	
鴻	hông	
鴿	kap, kah	
鵁	ka	
鵑	kuan	
鵝	gô, ngôo, giâ	
鵠	khok	khiat, khik
鵡		bú
鵤	kak	
鵪	ian	
鵬	phîng, pîng	
鵰	tiau	
鵲		tshik, tshiok
鵻	tsui	
鶉	tun, tshun	
鶖	tshiu	
鶯	ing	
鶴	ho̍h, ho̍k	
鶶		thâng
鶿	tsî	
鷓	tsià	
鷗	oo	
鷥	si	
鷹	ing	
鷺	lôo, lōo	
鸕	lôo	
鸚	ing	
鸞	luân	
鹹	kiâm	
鹼	kinn, kiám	
鹽	iâm, kiâm	
鹿	lo̍k, lak	
麒	kî	ki
麗	lē, lê	
麝	siā	
麟	lîn	lin
麥	be̍h	bē, bi̍k
麩	hu, phoo	pho
麭	pháng	
麴	khak	kak
麵	mī, biān	bīn
麶	thi	
麻	muâ, mâ, bâ	buâ
黃	n̂g, hông	uînn, ba
黍	sué, sé	sik
黎	lê	
黏	liâm	
黐	thi	
黑	hik	
黗	thûn	
默	bi̍k	
黛	tāi	
黜	thuh, thut	
點	tiám	
黨	tóng	
黯	ám	
黹	tsí	
黿		guân
鼇		ngôo
鼎	tiánn, tíng	
鼓	kóo	
鼠	tshí, tshú	
鼢	bùn	
鼻	phīnn	phī
鼾	huânn, kônn	
齁	honn	
齆	àng	
齊	tsê, tsiâu, tsuê, tsè	tsâu
齋	tsai, tse	
齒	khí	
齡	lîng	
齣	tshut	
齧	khè, khuè	khueh, kheh
齪	tsak	
齴	giàng	
齷	ak	
齻	tsan	
龍	lîng, liông, long, gîng, lâng, lông	liâng
龐	phiāng, pâng	
龔	kíng	
龕	kham	
龜	ku, kui	
𠕇	tīng	tān, tāinn
𠞩	tsuî	
𠞭	liô	
𠢕	gâu	
𠯗	tsi̍p	si̍p
𡢃	kán	
𡳞	lān	
𢪱	bu̍t	but
𢯾	mooh	
𢲸	lōo	
𢼌	pa	
𣁳	khat	
𣛮	siānn	siā
𣮈	khu̍t	khut
𣻸	siûnn	siônn
𤆬	tshuā	
𤉙	kûn	
𤲍	kheh, khueh	
𤶃	thiāu	
𤺅	tshè	tshuì, tsuè, tsè, tsheh, tshe̍h
𤺪	siān	
𥌚		bāi
𥍉	nih, liap	
𥐵	phiat	
𥑮	kóo	kó
𥰔	phín	
𥴊	kám	
𦉎	sui	
𦊓	lîng	
𦜆	ham	
𦟪	liân	
𧉟	tâi	
𧌄	am	âm, iam, àm, hám, ám, ham
𧮙	tshoh	tsho̍h
𧿬	thún	
𧿳	phu̍t	
𨂾	làm	
𨂿	uáinn, uainnh	uaih
𨑨	tshit, thit	
𩑾	tshih	
𩚨	khiū	
𩛩	kauh	
𩵱	ngóo	
𩸙	tāi	tâi
𩸶	gām	kām
𪁎	tshio	
𪐞	tòo	
𪜶	in	īn
𫝏	gàn	
𫝛	siāng	siâng
𫝺	hiù	
𫝻	huê	
𫞼	tshāi	
𫟂	hân	
𬦰	peh	
𰣻	ko	
